author,title,year,book_order,avg_rating,num_ratings,prev_year,years_since_last
a'lelia bundles,On Her Own Ground : The Life and Times of Madam C.J. Walker (Lisa Drew Books (Paperback)),2002,2,3,3,2001,1
"a. b., jr. guthrie",Murders at Moon Dance,1993,2,0,2,1980,13
a. c. baantjer,Dekok and the Sorrowing Tomcat,2001,2,0,1,1993,8
a. c. parfitt,Brooklyn Beckham: The Secret Diary,2001,2,3.6666666666666665,6,2001,0
a. h. almaas,"Diamond Heart, Book One : Elements of the Real in Man (The Diamond Heart Series , No 1)",2000,2,0,1,2000,0
a. j. holt,Watch Me,1996,2,3.35,20,1995,1
a. j. holt,Internet Kill. Psycho- Thriller.,1997,3,0,2,1996,1
a. j. holt,Catch Me,1999,4,5.5,2,1997,2
a. j. holt,Catch Me (A Jay Fletcher Thriller),2001,5,1.25,12,1999,2
a. m. homes,The Safety of Objects,1999,2,1.75,8,1991,8
a. m. homes,Music for Torching,1999,3,4.5,6,1999,0
a. m. homes,Music for Torching,2000,4,2.3333333333333335,3,1999,1
a. m. homes,Things You Should Know : A Collection of Stories,2002,5,3,3,2000,2
a. m. homes,Safety of Objects,2003,6,2.625,8,2002,1
a. m. homes,Things You Should Know : A Collection of Stories,2003,7,0,1,2003,0
a. m. monson,The Secret of Sanctuary Island,1992,2,0,1,1991,1
a. m. monson,Wanted: Best Friend,1997,3,3.25,4,1992,5
a. w. tozer,Divine Conquest,1992,2,0,1,1978,14
a. zee,Einstein's Universe: Gravity at Work and Play,2001,2,0,1,1987,14
a.a. milne,Once on a Time,1988,2,4.25,4,1987,1
a.a. milne,When We Were Very Young,1988,3,2.6666666666666665,6,1988,0
a.a. milne,Now We Are Six,1988,4,1.5,6,1988,0
a.a. milne,"Pooh's Library: Winnie-The-Pooh, the House at Pooh Corner, When We Were Very Young, Now We Are Six",1989,5,10,1,1988,1
a.a. milne,"Is That You, Winnie-the-Pooh?: A Lift the Flap Book",1990,6,0,1,1989,1
a.a. milne,Piglet Is Entirely Surrounded by Water: Pop-Up Storybook (A Winnie-the-Pooh pop-up storybook),1991,7,10,1,1990,1
a.a. milne,Pooh and Piglet Go Hunting (Pooh Jewelry Book),1992,8,5,2,1991,1
a.a. milne,Winnie-The-Pooh,1992,9,2.9545454545454546,22,1992,0
a.a. milne,The Complete Winnie-the-Pooh,1992,10,0,1,1992,0
a.a. milne,Eeyore Has a Birthday (A Winnie the Pooh Storybook),1993,11,4.5,4,1992,1
a.a. milne,Christopher Robin Leads an Expedition (A Winnie the Pooh Storybook),1993,12,5,2,1993,0
a.a. milne,Kanga and Baby Roo Come to the Forest (A Winnie the Pooh Storybook),1993,13,2.5,4,1993,0
a.a. milne,Winnie-The-Pooh's Teatime Cookbook,1993,14,10,1,1993,0
a.a. milne,Eeyore Loses a Tail (A Winnie-the-Pooh Storybook),1993,15,9,2,1993,0
a.a. milne,Pooh and Piglet Go Hunting (A Winnie-the-Pooh Storybook),1993,16,0,1,1993,0
a.a. milne,WHEN WE WERE VERY YOUNG(749702095,1995,17,8,1,1993,2
a.a. milne,All About Pooh (Winnie-the-Pooh),1995,18,0,1,1995,0
a.a. milne,Pooh: Now We Are Seventy,1996,19,8.5,2,1995,1
a.a. milne,Pooh's Bedtime Book,1996,20,10,1,1996,0
a.a. milne,How to Catch a Heffalump (Winnie The Pooh),1998,21,0,2,1996,2
a.a. milne,Winnie The Pooh and Tigger Too,1999,22,5,2,1998,1
a.a. milne,House at Pooh Corner,2000,23,3.3333333333333335,3,1999,1
a.e. hotchner,The Man Who Lived at the Ritz: A Novel by,1982,2,2,4,1979,3
a.e. hotchner,Hemingway and His World/1718196,1989,3,10,1,1982,7
a.e. hotchner,Blown Away/a No-Holds-Barred Portrait of the Rolling Stones and the Sixties,1991,4,3,2,1989,2
a.j. orde,Dead on Sunday,1994,2,4,2,1992,2
a.j. orde,Death for Old Times' Sake,1994,3,6,3,1994,0
a.j. orde,Death of Innocents (Jason Lynx Mystery),1997,4,0,1,1994,3
a.j. quinnell,Siege of Silence,1987,2,0,2,1987,0
a.j. quinnell,In the Name of the Father,1988,3,0,3,1987,1
a.m. rosenthal,The New York Times World of New York: An Uncommon Guide to the City of Fantasies,1986,2,8,1,1980,6
a.n. wilson,Who Was Oswald Fish?,1988,2,0,1,1984,4
a.n. wilson,Stray (Older Childrens Fiction),1989,3,0,1,1988,1
a.w. gray,Killings,1994,2,0,4,1992,2
aaa publishing,AAA Europe TravelBook : The Guide to Premier Destinations 2002 Edition,2002,2,0,1,2001,1
abbas milani,Tales of Two Cities: A Persian Memoir (Kodansha Globe),1997,2,0,1,1996,1
abby bardi,The Book of Fred : A Novel,2002,2,2,27,2001,1
abraham harold maslow,Toward a Psychology of Being (An Insight Book),1982,2,0,1,1968,14
abraham harold maslow,The Farther Reaches of Human Nature,1993,3,0,1,1982,11
abraham j. twerski,The Thin You Within You: Winning the Weight Game With Self-Esteem,1997,2,0,1,1992,5
ad hudler,Southern Living (Ballantine Reader's Circle),2003,2,3.6666666666666665,9,2002,1
ad hudler,Househusband,2004,3,3.75,4,2003,1
adam barrow,Blind Spot,1997,2,0,1,1996,1
adam barrow,Blind Spot,1998,3,2.125,8,1997,1
adam beechen,The Cost of Cool,2002,2,0,2,2001,1
adam beechen,Twister's Big Break (Rocket Power),2002,3,0,2,2002,0
adam beechen,Jimmy on Ice,2003,4,8,2,2002,1
adam beechen,No More Mr. Smart Guy,2003,5,0,1,2003,0
adam c. engst,Internet Starter Kit for Windows 95,1995,2,0,1,1994,1
adam c. engst,Internet Starter Kit for Windows,1995,3,0,1,1995,0
adam j. jackson,The Ten Secrets of Abundant Health,1996,2,0,1,1996,0
adam j. jackson,Los Diez Secretos Del Amor Abundante,2001,3,9,1,1996,5
adam lebor,Hitler's Secret Bankers: The Myth of Swiss Neutrality During the Holocaust,2000,2,0,1,1998,2
adam smith,Money Game,1975,2,8.5,2,1970,5
adam smith,Powers of mind,1975,3,0,1,1975,0
adam smith,Powers of the Mind,1976,4,0,1,1975,1
adam smith,Powers of the Mind,1976,5,0,1,1976,0
adam smith,Money Game,1976,6,0,2,1976,0
adam smith,An Inquiry into the Nature and Causes of the Wealth of Nations/2 Volumes in 1,1977,7,0,1,1976,1
adam smith,Paper Money,1981,8,0,1,1977,4
adam smith,Powers of Mind,1982,9,0,1,1981,1
adam smith,The Wealth of Nations: An Inquiry into the Nature and Causes (Modern Library (Hardcover)),1993,10,0,1,1982,11
adam smith,"The Wealth of Nations, Books IV-V (Penguin Classics)",2000,11,0,1,1993,7
adele griffin,Split Just Right,1997,2,0,1,1997,0
adele griffin,Rainy Season,1998,3,0,1,1997,1
adele griffin,The Other Shepards,1998,4,0,2,1998,0
adele griffin,The Other Shepards,1999,5,0,1,1998,1
adele griffin,Witch Twins (Witch Twins),2001,6,0,1,1999,2
adele griffin,Amandine,2001,7,7,1,2001,0
adele read,"The Enchanted Attic (Choose  Your Own Adventure, No. 52)",1995,2,0,1,1992,3
adib khan,Solitude of illusions,1996,2,7,1,1995,1
adobe systems inc,Adobe Premiere (Classroom in a book),1993,2,4.5,2,1985,8
adrian gilbert,The Mayan Prophecies : Unlocking the Secrets of a Lost Civilization,1996,2,0,2,1995,1
adrian gilbert,The Mayan Prophecies: Unlocking the Secrets of a Lost Civilization,1996,3,2.3333333333333335,3,1996,0
adrian gilbert,Stalk and Kill,1998,4,0,1,1996,2
adrian nye,Xlib programming manual (The Definitive guides to the X Window System),1990,2,0,1,1988,2
adrian nye,Volume 1 : Xlib Programming Manual (Definitive Guides to the X Window System),1992,3,0,1,1990,2
adriane g. berg,The Totally Awesome Money Book for Kids (And Their Parents),1993,2,7,1,1991,2
adriane g. berg,The Totally Awesome Business Book for Kids: With Twenty Super Businesses You Can Start Right Now!,1995,3,0,1,1993,2
adrienne ellis reeves,Reckless,2003,2,0,1,1995,8
agnes sanford,The Healing Touch of God,1983,2,0,1,1971,12
agnes sanford,The Healing Gifts of the Spirit,1984,3,0,1,1983,1
ahmadou kourouma,Allah n'est pas obligÃ©: Roman,2000,2,0,2,1990,10
ahmadou kourouma,Allah n'est pas obligÃ?Â©,2002,3,2.6666666666666665,3,2000,2
ahmadou kourouma,Die NÃ?Â¤chte des groÃ?Â?en JÃ?Â¤gers.,2002,4,0,2,2002,0
ahmadou kourouma,Allah muss nicht gerecht sein.,2002,5,9,2,2002,0
ahmed osman,Moses and Akhenaten: The Secret History of Egypt at the Time of the Exodus,2002,2,0,1,1994,8
aidan macfarlane,The Diary of a Teenage Health Freak,2002,2,3.5,2,1996,6
aileen ludington,"Health Power: Health by Choice, Not Chance",2001,2,0,1,2001,0
al cody,Trappers' Rendezvous (Atlantic Large Print Series),1991,2,0,2,1988,3
al kaltman,The Genius of Robert E. Lee,2000,2,7,1,1998,2
alai,Red Poppies,2002,2,0,4,2002,0
alai,Red Poppies,2002,3,0,1,2002,0
alai,Red Poppies : A Novel of Tibet,2003,4,0,1,2002,1
alain debotton,Isabel.,2002,2,5.333333333333333,3,2002,0
alain debotton,Kunst des Reisens.,2003,3,0,10,2002,1
alan epstein,How to Be Happier Day by Day: A Year of Mindul Actions,1994,2,7,1,1993,1
alan epstein,"As the Romans Do: The Delights, Dramas, and Daily Diversions of Life in the Eternal City",2000,3,6.5,2,1994,6
alan epstein,As the Romans Do: An American Family's Italian Odyssey,2001,4,7.4,5,2000,1
alan fields,"Baby Bargains: Secrets to Saving 20% to 50% on Baby Furniture, Equipment, Clothes, Toys, Maternity Wear and Much, Much More!",2003,2,9,1,2002,1
alan goodman,"A SLASH IN THE NIGHT THE MYSTERY FILES OF SHELBY WOO 1 (Mystery Files of Shelby Woo , No 1)",1997,2,7,1,1994,3
alan moore,Saga of the Swamp Thing,1987,2,8,1,1987,0
alan moore,Batman: The Killing Joke (Batman (DC Comics Paperback)),1995,3,8,1,1987,8
alan moore,Watchmen,1995,4,5.2727272727272725,22,1995,0
alan moore,Swamp Thing: Love and Death - Book 2,1995,5,10,1,1995,0
alan moore,V for Vendetta,1995,6,7.142857142857143,7,1995,0
alan moore,Saga of the Swamp Thing - Book 1 (DC Comics Vertigo (Paperback)),1998,7,9,2,1995,3
alan moore,FROM HELL,2000,8,1.8333333333333333,6,1998,2
alan moore,Tom Strong,2000,9,9,1,2000,0
alan moore,Tom Strong - Book One,2001,10,5,1,2000,1
alan moore,"The League of Extraordinary Gentlemen, Vol. 1",2001,11,9.5,2,2001,0
alan moore,Swamp Thing: A Murder of Crows - Book 4,2001,12,10,1,2001,0
alan moore,Promethea: Collected Edition Book 2,2001,13,8,1,2001,0
alan moore,Top Ten (Book 1),2001,14,8,2,2001,0
alan moore,Swamp Thing: Earth to Earth - Book 5 (Swamp Thing),2002,15,5,1,2001,1
alan moore,"The League of Extraordinary Gentlemen, Vol. 1",2002,16,3.6451612903225805,31,2002,0
alan moore,"League of Extraordinary Gentlemen, Vol. 2 (Comic)",2003,17,6,4,2002,1
alan moore,Another Suburban Romance,2003,18,8,1,2003,0
alan moore,A Small Killing,2003,19,7,1,2003,0
alan moore,Alan Moore's Writing for Comics,2003,20,6.666666666666667,3,2003,0
alan moore,The Complete D.R. &amp; Quinch (2000 AD Presents S.),2003,21,0,1,2003,0
alan moore,Tom Strong - Book Two of the Heroic New Series,2003,22,5,2,2003,0
alan parry,Little Prayer Series: Bedtime Prayers,1995,2,0,3,1994,1
alan parry,Little Prayer Series: Mealtime Prayers,1995,3,0,2,1995,0
alan parry,Time To Pray Series: Prayers For Bedtime,1997,4,0,1,1995,2
alan parry,Bear's First Bible,2001,5,0,1,1997,4
alan saperstein,Camp,1984,2,0,1,1979,5
alan saperstein,How Old Was Lolita?,1987,3,0,1,1984,3
alan saperstein,How Old Was Lolita?,1988,4,0,2,1987,1
alan schroeder,Presidential Debates,2000,2,8,1,1989,11
alan vanneman,Sherlock Holmes and the Giant Rat of Sumatra,2002,2,1.5,4,2002,0
alan weisman,An Echo in My Blood: The Search for My Family's Hidden Past,1999,2,10,2,1999,0
alanna nash,Behind Closed Doors: Talking With the Legends of Country Music,1988,2,0,1,1988,0
alanna nash,Golden Girl Savitch,1989,3,0,2,1988,1
alanna nash,Golden Girl : The Story of Jessica Savitch,1996,4,0,2,1989,7
alanna nash,Elvis Aaron Presley: Revelations from the Memphis Mafia,1996,5,4,2,1996,0
alastair reynolds,Revelation Space (Gollancz SF S.),2001,2,1.5,10,2001,0
alastair reynolds,Chasm City (Gollancz SF S.),2002,3,6,2,2001,1
alastair reynolds,Revelation Space,2002,4,2.8,15,2002,0
alastair reynolds,Redemption Ark (Gollancz SF S.),2002,5,5,1,2002,0
alastair reynolds,Chasm City,2002,6,1.8,5,2002,0
alastair reynolds,"Diamond Dogs, Turquoise Days (Gollancz SF S.)",2003,7,4,2,2002,1
alastair reynolds,"Diamond Dogs, Turquoise Days (Gollancz SF S.)",2003,8,0,2,2003,0
alastair reynolds,Redemption Ark (Gollancz SF S.),2003,9,0,1,2003,0
alastair reynolds,Chasm City,2003,10,0,5,2003,0
alastair reynolds,Redemption Ark,2003,11,8,1,2003,0
alastair reynolds,Absolution Gap,2004,12,10,1,2003,1
albert harry goldman,Elvis,1984,2,1,1,1974,10
albert jackson,The Complete Manual of Woodworking,1997,2,5,1,1993,4
alberto manguel,Dark Arrows: Great Stories of Revenge,1987,2,0,5,1984,3
alberto manguel,Evening Games: Tales of Parents and Children,1988,3,0,2,1987,1
alberto manguel,Black Water 2: More Tales of the Fantastic,1990,4,0,1,1988,2
alberto manguel,The Oxford Book of Canadian Ghost Stories,1990,5,0,2,1990,0
alberto manguel,News from a Foreign Country Came,1991,6,0,1,1990,1
alberto manguel,A History of Reading,1996,7,1.8,5,1991,5
alberto manguel,The Second Gates of Paradise: The Anthology of Erotic Short Fiction,1997,8,7,1,1996,1
alberto manguel,A History of Reading,1997,9,3.3333333333333335,3,1997,0
alberto manguel,The Ark in the Garden: Fables for Our Times,1998,10,10,1,1997,1
alberto manguel,Mothers &amp; Daughters: An Anthology,1998,11,0,1,1998,0
alberto manguel,By the Light of the Glow-Worm Lamp: Three Centuries of Reflections on Nature,1998,12,0,1,1998,0
alberto manguel,The Dictionary of Imaginary Places: The Newly Updated and Expanded Classic,1999,13,10,1,1998,1
alberto manguel,On Lying in Bed and Other Essays by G.K. Chesterton,2000,14,7,1,1999,1
alberto manguel,Im Spiegelreich.,2000,15,0,1,2000,0
alberto manguel,"Into the Looking-Glass Wood: Essays on Books, Reading, and the World",2000,16,0,3,2000,0
alberto manguel,Dictionnaire des lieux imaginaires,2001,17,8,1,2000,1
alberto manguel,Second Gates of Paradise: The Anthology of Erotic Short Fiction,2001,18,5,1,2001,0
aldous l. huxley,Un Mundo Feliz,2004,2,3,5,1995,9
alec wilkinson,A Violent Act,1993,2,0,1,1989,4
alejandro dumas,"Tres Mosqueteros, Los",1998,2,9,1,1992,6
alejandro dumas,"Tres Mosqueteros, Los",1998,3,10,1,1998,0
alejandro dumas,Los Tres Mosqueteros,1998,4,0,1,1998,0
alejandro dumas,El tulipÃ¡n negro,2000,5,0,1,1998,2
alejandro dumas,"Tres Mosqueteros, Los: Adaptacic\n""""",2001,6,0,3,2000,1
alejandro dumas,Conde de Montecristo,2001,7,0,2,2001,0
alejandro dumas,El Conde De Montecristo,2004,8,4,2,2001,3
alex matthews,Satan's Silence: The Second Cassidy McCabe Mystery (The Second Cassidy Mccabe Mystery),1998,2,0,1,1998,0
alex matthews,Vendetta's Victim: The Third Cassidy McCabe Mystery (Cassidy McCabe Mysteries (Paperback)),1999,3,0,1,1998,1
alex matthews,Wanton's Web : The Fourth Cassidy McCabe Mystery,2001,4,0,1,1999,2
alex matthews,Cat's Claw (Cassidy McCabe Mysteries (Paperback)),2001,5,0,1,2001,0
alex matthews,"Wedding's Widow (Matthews, Alex. Cassidy Mccabe Mystery, 7th.)",2003,6,10,1,2001,2
alex shakar,The Savage Girl,2002,2,1.5,10,2001,1
alexander lowen,"Love, Sex, and Your Heart",1988,2,0,1,1985,3
alexander lowen,Bioenergetics (Arkana S.),1994,3,7,1,1988,6
alexandra penney,The Sexiest Sex of All,1994,2,6,1,1982,12
alexandra potter,Calling Romeo,2004,2,3.142857142857143,7,2003,1
alexs d. pate,Amistad: A Novel,1997,2,1.6153846153846154,13,1995,2
alexs d. pate,The Multicultiboho Show,1999,3,0,3,1997,2
alexs d. pate,West of Rehoboth: A Novel,2001,4,0,1,1999,2
alexs d. pate,West of Rehoboth : A Novel,2002,5,0,1,2001,1
alf proysen,Mrs. Pepperpot in the Magic Wood (Young Puffin Books),1988,2,0,1,1988,0
alf proysen,Mrs. Pepperpot in the Magic Wood (Puffin Modern Classics),1995,3,9,1,1988,7
alfred birnbaum,Zen for Cats: Teachings of the Zen Cat Masters,1993,2,9,1,1991,2
alfred birnbaum,Zen for Cats: Teachings of the Zen Cat Masters,1993,3,3.5555555555555554,9,1993,0
alfred birnbaum,Monkey Brain Sushi: New Tastes in Japanese Fiction (Japan's Modern Writers),1993,4,1.75,4,1993,0
alfred birnbaum,Monkey Brain Sushi: New Tastes in Japanese Fiction,2002,5,0,1,1993,9
alfred bosch,L'atles furtiu (ColÂ¨lecciÃ³ clÃ ssica),1998,2,4.25,4,1996,2
alfred j. kolatch,The Second Jewish Book of Why,1995,2,6,1,1990,5
alfred kazin,Selected Short Stories of Nathaniel Hawthorne,1993,2,3,3,1983,10
alfred lansing,Endurance : Shackleton's Incredible Voyage,1998,2,4,2,1994,4
alfred lansing,Endurance: Shackleton's Incredible Voyage,1999,3,3.097560975609756,41,1998,1
alfred lansing,635 Tage im Eis. Die Shackleton- Expedition.,2000,4,3.5,2,1999,1
alfred lansing,Endurance: Shackleton's Incredible Voyage to the Antarctic (Illustrated Edition),2001,5,10,1,2000,1
alfred werner,Inness Landscapes,1999,2,10,1,1988,11
alfredo gomez cerda,"LA Puerta Falsa (Gran Angular, 210)",2001,2,0,2,1998,3
alice cary,Parents' Guide to Hiking &amp; Camping: A Trailside Guide (Trailside Guide Series),1997,2,0,1,1995,2
alice chambers,Always a Princess,2001,2,0,1,2000,1
alice gray,Stories for the Heart: The Original Collection,1996,2,3.2666666666666666,15,1996,0
alice gray,Stories for the Heart,1996,3,9,1,1996,0
alice gray,More Stories for the Heart (Stories For the Heart),1997,4,3.125,8,1996,1
alice gray,More Stories for the Heart (Stories For the Heart),1997,5,0,1,1997,0
alice gray,Christmas Stories for the Heart (Stories For the Heart),1998,6,7,4,1997,1
alice gray,Stories for the Family's Heart (Stories For the Heart),1998,7,2.5,6,1998,0
alice gray,Stories for a Woman's Heart,1999,8,5.375,8,1998,1
alice gray,Lists to Live By:  The First Collection : For Everything that Really Matters (Lists to Live By),1999,9,3.736842105263158,19,1999,0
alice gray,Stories for a Teen's Heart (Stories For the Heart),1999,10,2.888888888888889,9,1999,0
alice gray,Stories for a Faithful Heart,1999,11,0,2,1999,0
alice gray,A Fragrance of Friendship (Katia Andreeva Watercolors),2000,12,2.6666666666666665,3,1999,1
alice gray,Stories for the Extreme Teen's Heart (Stories for the Heart Series Endcap Kit),2000,13,5.8,5,2000,0
alice gray,Stories for a Kindred Heart : Over 100 Treasures to Lift Your Soul (Stories For the Heart),2000,14,0,2,2000,0
alice gray,Lists to Live By: The First Collection Special Edition Books are Fun,2000,15,0,1,2000,0
alice gray,Stories for a Woman's Heart: Second Collection (Stories For the Heart),2001,16,0,1,2000,1
alice gray,Stories for the Extreme Teen's Heart,2001,17,0,1,2001,0
alice gray,Lists to Live By: The Third Collection : For Everything That Really Matters (Lists to Live By),2001,18,4.333333333333333,6,2001,0
alice gray,Stories for the Heart: The Second Collection (Stories For the Heart),2001,19,0,1,2001,0
alice gray,Lists to Live By for Every Married Couple (Lists to Live By),2001,20,7,1,2001,0
alice gray,Lists to Live By: The Second Collection,2001,21,5.5,4,2001,0
alice gray,Stories for a Romantic Heart - gift book (Stories For the Heart),2001,22,8,1,2001,0
alice gray,Stories for a Teen's Heart: Book 3,2002,23,10,1,2001,1
alice gray,Lists to Live By For Smart Living,2002,24,0,1,2002,0
alice gray,Lists to Live By: The Fourth Collection : For Everything That Really Matters (Lists to Live By),2002,25,0,1,2002,0
alice gray,Stories for a Teacher's Heart (Stories For the Heart),2002,26,0,1,2002,0
alice gray,Stories From a Soldier's Heart: For the Patriotic Soul,2003,27,9,1,2002,1
alice mcdermott,At Weddings and Wakes,1993,2,0.7333333333333333,15,1993,0
alice mcdermott,Charming Billy,1998,3,2.75,8,1993,5
alice mcdermott,A Bigamist's Daughter,1999,4,5,9,1998,1
alice mcdermott,At Weddings and Wakes,1999,5,2.0526315789473686,19,1999,0
alice mcdermott,Charming Billy,1999,6,2.6090225563909772,133,1999,0
alice mcdermott,That Night,1999,7,3,8,1999,0
alice mcdermott,Child of My Heart,2002,8,2.4262295081967213,61,1999,3
alice mcdermott,Child of My Heart,2002,9,5,2,2002,0
alice mcdermott,Irischer Abschied. Roman.,2002,10,0,1,2002,0
alice mcdermott,Child of My Heart : A Novel,2003,11,3.8666666666666667,15,2002,1
alice schwarzer,Eine tÃ¶dliche Liebe: Petra Kelly und Gert Bastian,1993,2,6,1,1984,9
alice schwarzer,Marion DÃ¶nhoff: Ein widerstÃ¤ndiges Leben,1996,3,8,1,1993,3
alice schwarzer,"Der kleine Unterschied und seine groÃ?Â?en Folgen. Frauen Ã?Â¼ber sich, Beginn einer Befreiung.",2002,4,4.5,2,1996,6
alice turner curtis,Little Maid of Virginia (Little Maid),1998,2,4.333333333333333,3,1995,3
alice turner curtis,Little Maid of Old Maine (Little Maid),1999,3,0,1,1998,1
alice zillman chapin,The Little Book of Big Bible Promises for Women (Little Book of Big Bible Promises),2001,2,0,1,2000,1
alicia alvrez,Ladies' Room Reader: The Ultimate Women's Trivia Book,2001,2,2.6666666666666665,9,1995,6
alicia alvrez,The Ladies Room Reader: The Ultimate Women's Trivia Book,2002,3,8,1,2001,1
alicia alvrez,Mama Says: Best Advice from Some of the World's Best Mothers,2004,4,0,1,2002,2
alii m. bek,"The Awakening (The Children of the Anarii, Book II)",1998,2,8,1,1996,2
alii m. bek,"The Becoming (The Children of the Anarii, Book III)",2000,3,8,1,1998,2
aliki,"Use Your Head, Dear",1983,2,0,1,1982,1
aliki,Feelings,1984,3,0,1,1983,1
aliki,My Visit to the Dinosaurs (Let's-read-and-find-out science book),1985,4,0,1,1984,1
aliki,Mummies Made in Egypt,1985,5,10,1,1985,0
aliki,My Visit to the Dinosaurs (Let's-Read-and-Find-Out Science 2),1985,6,7.5,2,1985,0
aliki,Feelings,1986,7,0,2,1985,1
aliki,Corn Is Maize (Let's-Read-and-Find-Out Science 2),1986,8,9,1,1986,0
aliki,"MANY LIVES OF BENJAMIN FRANKLIN, THE",1988,9,0,2,1986,2
aliki,Digging Up Dinosaurs (Let's-Read-and-Find-Out Science 2),1988,10,2.5,4,1988,0
aliki,Digging Up Dinosaurs (Let's-read-and-find-out science book),1988,11,0,3,1988,0
aliki,My Five Senses (Let's-Read-and-Find-Out Science 1),1989,12,0,1,1988,1
aliki,Manners,1990,13,0,1,1989,1
aliki,Dinosaur Bones (Let's-Read-and-Find-Out Science 2),1990,14,8,1,1990,0
aliki,Fossils Tell of Long Ago (Let's-Read-and-Find-Out Science 2),1990,15,3.3333333333333335,3,1990,0
aliki,My Feet (Let's-Read-and-Find-Out Science 1),1992,16,5,2,1990,2
aliki,The Big Book for Our Planet,1993,17,7,1,1992,1
aliki,Communication,1993,18,0,1,1993,0
aliki,All by Myself!,2000,19,8,1,1993,7
aliske webb,Twelve Golden Threads: Lessons for Successful Living from Grama's Quilt,1997,2,1.6,5,1996,1
aliske webb,The Fragile Thread,1998,3,1.6,5,1997,1
aliske webb,ZwÃ?Â¶lf goldene FÃ?Â¤den. Lebensweisheiten einer wundervollen Grossmutter.,1999,4,10,1,1998,1
alison cragin herzig,Sam and the Moon Queen,1990,2,5,1,1978,12
alison cragin herzig,Mystery on October Road,1991,3,0,1,1990,1
alison cragin herzig,Mystery on October Road (A Puffin Book),1993,4,5,1,1991,2
alison cragin herzig,The Boonsville Bombers,1993,5,2.5,2,1993,0
alison cragin herzig,Weekly Reader Children's Book Club presents Silly Steggy,1993,6,0,1,1993,0
alison green,Postman Pat's 123,1994,2,7,1,1994,0
alison inches,Wendy Helps Out (Bob The Builder),2001,2,7,1,1996,5
alison inches,Run-Away Roley,2002,3,0,2,2001,1
alison lurie,Only Children,1979,2,0,1,1974,5
alison lurie,Foreign Affairs-Op/20,1985,3,3.2222222222222223,9,1979,6
alison lurie,The Truth About Lorin Jones,1988,4,0,2,1985,3
alison lurie,Ein ganz privater kleiner Krieg. Roman.,1988,5,5,1,1988,0
alison lurie,Les amours d'Emily Turner,1989,6,0,1,1988,1
alison lurie,Only Children,1990,7,0,3,1989,1
alison lurie,La vÃ?Â©ritÃ?Â© sur Lorin Jones,1990,8,7,1,1990,0
alison lurie,Don't Tell the Grown-Ups: Subversive Children's Literature (Don't Tell the Grown-Ups),1990,9,0,1,1990,0
alison lurie,The Truth About Lorin Jones,1990,10,0,2,1990,0
alison lurie,The War Between the Tates,1991,11,0,2,1990,1
alison lurie,Imaginary Friends,1991,12,0,3,1991,0
alison lurie,Die Wahrheit Ã?Â¼ber Lorin Jones. Roman.,1992,13,5,1,1991,1
alison lurie,Des amis imaginaires,1992,14,8,2,1992,0
alison lurie,The Oxford Book of Modern Fairy Tales,1993,15,0,2,1992,1
alison lurie,Comme des enfants,1993,16,7,1,1993,0
alison lurie,The Oxford Book of Modern Fairy Tales,1994,17,9,1,1993,1
alison lurie,Foreign Affairs,1995,18,3,12,1994,1
alison lurie,Women and Ghosts,1995,19,7,1,1995,0
alison lurie,The Nowhere City,1997,20,1.875,8,1995,2
alison lurie,Love and Friendship,1997,21,2.3333333333333335,3,1997,0
alison lurie,Real People,1998,22,5,3,1997,1
alison lurie,The Last Resort,1998,23,7,1,1998,0
alison lurie,Don't Tell the Grown-Ups : The Subversive Power of Children's Literature,1998,24,4.5,2,1998,0
alison lurie,The Last Resort: A Novel,1998,25,3.25,4,1998,0
alison lurie,Imaginary Friends,1998,26,0,4,1998,0
alison lurie,Foreign Affairs,1999,27,0,2,1998,1
alison lurie,The Last Resort,1999,28,3,2,1999,0
alison lurie,The Language of Clothes,2000,29,7,1,1999,1
alison lurie,AffÃ?Â¤ren. Eine transatlantische Liebesgeschichte.,2001,30,0,1,2000,1
alison plowden,The Stuart Princess,1997,2,7,1,1976,21
alison plowden,Two Queens in One Isle: The Deadly Relationship of Elizabeth I &amp; Mary Queen of Scots,1999,3,7,1,1997,2
alison plowden,Young Elizabeth: The First Twenty-Five Years,1999,4,7,1,1999,0
alison plowden,The Young Victoria,2000,5,7,1,1999,1
alison plowden,Lady Jane Grey: Nine Days Queen,2003,6,0,1,2000,3
alison roberts,Emotional Rescue (Medical Romance),2001,2,0,1,1999,2
alison roberts,Nurse in Need (Medical Romance),2001,3,0,1,2001,0
alison roberts,Emotional Rescue (Medical Romance),2001,4,0,1,2001,0
alison roberts,Emergency: Christmas (Harlequin Heartbeat),2003,5,0,2,2001,2
alison roberts,Double Duty,2003,6,0,2,2003,0
alison scott skelton,Family Story: A Novel,1995,2,0,4,1988,7
alison scott skelton,Family Story,1996,3,0,5,1995,1
alison sinclair,Legacies : Legacies,1996,2,2.25,4,1996,0
alison strickland,"Washington, D.C.: Our Nation's Capital",1985,2,5,1,1983,2
alison strickland,That Doggone Dog (Willowisp Sappling (Sic)),1987,3,0,1,1985,2
alison wearing,Honeymoon in Purdah: An Iranian Journey,2000,2,4,2,1988,12
alison wearing,Honeymoon in Purdah: An Iranian Journey,2001,3,2.142857142857143,7,2000,1
alison weir,Six Wives of Henry VIII,1993,2,3.7777777777777777,9,1992,1
alison weir,The Princes in the Tower,1994,3,1.1428571428571428,7,1993,1
alison weir,The Princes in the Tower,1995,4,0.3,10,1994,1
alison weir,The Wars of the Roses,1995,5,0,1,1995,0
alison weir,The Wars of the Roses,1996,6,4,2,1995,1
alison weir,The Children of Henry VIII,1996,7,3,3,1996,0
alison weir,The Children of Henry VIII,1997,8,2.857142857142857,7,1996,1
alison weir,Life of Elizabeth I,1998,9,7,1,1997,1
alison weir,The Life of Elizabeth I,1999,10,3.272727272727273,11,1998,1
alison weir,Six Wives of Henry VIII,2000,11,4.4,10,1999,1
alison weir,Eleanor of Aquitaine : A Life,2000,12,1.5,2,2000,0
alison weir,Eleanor of Aquitaine: A Life (Ballantine Reader's Circle),2001,13,4.611111111111111,18,2000,1
alison weir,Henry VIII : The King and His Court,2001,14,5.666666666666667,3,2001,0
alison weir,Henry VIII: The King and His Court (Ballantine Reader's Circle),2002,15,2,4,2001,1
alison weir,"Mary, Queen of Scots and the Murder of Lord Darnley",2003,16,2.25,4,2002,1
alison weir,"Mary, Queen of Scots, and the Murder of Lord Darnley",2004,17,0,1,2003,1
alistair maclean,Ice Station Zebra,1960,2,0,1,1957,3
alistair maclean,H.M.S. Ulysses,1960,3,0,1,1960,0
alistair maclean,The Guns of Navarone,1968,4,3.5,2,1960,8
alistair maclean,Dark Crusader,1969,5,0,1,1968,1
alistair maclean,Puppet on a chain,1969,6,0,1,1969,0
alistair maclean,Puppet on a Chain,1969,7,0,1,1969,0
alistair maclean,Caravan to Vaccares,1970,8,0,1,1969,1
alistair maclean,The Golden Rendezvous,1970,9,0,1,1970,0
alistair maclean,Bear Island,1971,10,0,1,1970,1
alistair maclean,The way to dusty death,1973,11,0,1,1971,2
alistair maclean,Breakheart Pass,1974,12,0,2,1973,1
alistair maclean,Circus,1975,13,0,1,1974,1
alistair maclean,The Golden Gate,1976,14,0,1,1975,1
alistair maclean,GOLDEN RENDEZVOUS,1976,15,0,1,1976,0
alistair maclean,Where Eagles Dare,1976,16,0,1,1976,0
alistair maclean,Goodbye California,1977,17,5,1,1976,1
alistair maclean,Seawitch,1977,18,0,1,1977,0
alistair maclean,Seawitch,1977,19,0,2,1977,0
alistair maclean,Circus,1977,20,0,5,1977,0
alistair maclean,Goodbye California,1978,21,3.3333333333333335,3,1977,1
alistair maclean,Seawitch,1978,22,0,1,1978,0
alistair maclean,Goodbye California,1979,23,0,1,1978,1
alistair maclean,Breakheart Pass,1980,24,3.5,2,1979,1
alistair maclean,SEAWITCH,1981,25,1,10,1980,1
alistair maclean,Circus,1981,26,1.3333333333333333,6,1981,0
alistair maclean,Golden Gate,1981,27,1.5,4,1981,0
alistair maclean,Golden Rendezvous,1981,28,0,1,1981,0
alistair maclean,South by Java Head,1981,29,0,2,1981,0
alistair maclean,The Black Shrike,1981,30,5,1,1981,0
alistair maclean,Athabasca,1982,31,0,5,1981,1
alistair maclean,Satan Bug,1983,32,0,3,1982,1
alistair maclean,When Eight Bells Toll,1983,33,0,1,1983,0
alistair maclean,River of Death,1983,34,0.8571428571428571,7,1983,0
alistair maclean,South by Java Head,1983,35,0,1,1983,0
alistair maclean,Floodgate,1984,36,0,2,1983,1
alistair maclean,Caravan to Vaccares,1984,37,0,2,1984,0
alistair maclean,San Andreas,1986,38,1.75,16,1984,2
alistair maclean,Caravan to Vaccares,1987,39,0,1,1986,1
alistair maclean,The Lonely Sea,1987,40,1.5,4,1987,0
alistair maclean,Bear Island,1988,41,0,4,1987,1
alistair maclean,Santorini,1988,42,2,10,1988,0
alistair maclean,Night Without End,1988,43,8,1,1988,0
alistair maclean,River of Death,1988,44,0,1,1988,0
alistair maclean,Where Eagles Dare,1988,45,6,1,1988,0
alistair maclean,Floodgate,1990,46,1,9,1988,2
alistair maclean,Athabasca,1990,47,0,2,1990,0
alistair maclean,The Golden Gate,1990,48,0,1,1990,0
alistair maclean,Ice Station Zebra,1990,49,8,1,1990,0
alistair maclean,Seawitch,1990,50,0,1,1990,0
alistair maclean,Night Without End (Oxford Bookworms S.),1992,51,5,1,1990,2
alistair maclean,Guns of Navarone,1994,52,1.4285714285714286,7,1992,2
alistair maclean,Die schwarze Hornisse.,1994,53,0,1,1994,0
alistair maclean,Alistair MacLean's Zeit der AttentÃ?Â¤ter.,1995,54,0,1,1994,1
alistair maclean,Floodgate,1995,55,8,1,1995,0
alistair maclean,Athabasca,1996,56,3,2,1995,1
alistair maclean,Codebreaker.,1998,57,0,1,1996,2
alistair maclean,Die MÃ?Â¤nner von Navarone.,1999,58,3.5,2,1998,1
alistair maclean,Die Erpressung / Golden Gate. Zwei Romane in einem Band.,2001,59,7,1,1999,2
alistair maclean,Hms Ulysses (Isis Nonfiction),2001,60,10,1,2001,0
alistair maclean,Where Eagles Dare (Adrenaline Classics Series),2002,61,0,3,2001,1
allan bloom,CLOSING OF THE AMERICAN MIND,1988,2,2.3333333333333335,21,1987,1
allan bloom,Giants and Dwarfs : Essays 1960-1990,1991,3,0,1,1988,3
allan bloom,LOVE AND FRIENDSHIP,1994,4,0,2,1991,3
allan topol,Dark Ambition,2003,2,1.625,8,2001,2
allan topol,Conspiracy,2004,3,3.75,4,2003,1
allan zullo,Haunted Animals: True Ghost Stories,1995,2,3.6666666666666665,3,1994,1
allan zullo,The Haunted Graveyard and Other True Ghost Stories,1996,3,0,2,1995,1
allan zullo,Haunted Campers: True Ghost Stories (True Ghost Stories),1996,4,0,7,1996,0
allan zullo,Haunted Schools: True Ghost Stories (True Ghost Stories),1996,5,8,2,1996,0
allan zullo,Mysteries Of The Unexplained,1996,6,0,1,1996,0
allan zullo,The president who pardoned a turkey and other wacky tales of American history,1996,7,5.666666666666667,3,1996,0
allan zullo,Sick Humor,1996,8,0,1,1996,0
allan zullo,Haunted Kids: True Ghost Stories (True Ghost Stories),1997,9,3.3333333333333335,3,1996,1
allan zullo,The Ten Creepiest Places in America,1997,10,0,5,1997,0
allan zullo,Haunted Athletes: True Ghost Stories (True Ghost Stories),1997,11,0,2,1997,0
allan zullo,Haunted Baby-Sitters: True Ghost Stories (True Ghost Stories),1997,12,0,3,1997,0
allan zullo,Haunted Teachers: True Ghost Stories,1997,13,0,5,1997,0
allan zullo,Could It Be True?,1998,14,3.6666666666666665,3,1997,1
allan zullo,When Bad Things Happen to Good Golfers: Pro Golf's Greatest Disasters,1998,15,0,1,1998,0
allan zullo,True Tales of Animal Heroes,1998,16,5.4,5,1998,0
allan zullo,Greatest Survivor Stories Never Told,2002,17,7,1,1998,4
allen morris jones,Last Year's River: A Novel,2002,2,3,3,2001,1
allen steele,Rude Astronauts: Real and Imagined Stories,1995,2,2.3333333333333335,3,1991,4
allen steele,The Tranquillity Alternative,1997,3,0,3,1995,2
allen steele,A King of Infinite Space: A Novel,1997,4,5,1,1997,0
allen steele,"All American Alien Boy: The United States As Science Fiction, Science Fiction As a Journey; A Collection",1997,5,0,1,1997,0
allen steele,"Clarke County, Space",2000,6,1.3333333333333333,6,1997,3
allen steele,Orbital Decay,2000,7,0,7,2000,0
allen steele,Labyrinth of Night: A Novel of Mars,2001,8,1.4444444444444444,9,2000,1
allen steele,Chronospace,2002,9,5.333333333333333,3,2001,1
allen steele,Coyote,2003,10,0,2,2002,1
allen wier,Blanco,1989,2,0,1,1989,0
alphonso pinkney,Black Americans (5th Edition),1999,2,0,1,1986,13
alston chase,In a Dark Wood: The Fight over Forests&amp;the Myths of Nature,2001,2,0,1,1995,6
alvin schwartz,Witcracks: Jokes and Jests from American Folklore,1977,2,0,3,1975,2
alvin schwartz,"Ten copycats in a boat, and other riddles (An I can read book)",1980,3,0,1,1977,3
alvin schwartz,Scary Stories to Tell in the Dark: Collected from American Folklore,1981,4,0,1,1980,1
alvin schwartz,Scary Stories to Tell in the Dark: Collected from American Folklore,1981,5,5,3,1981,0
alvin schwartz,"There is a carrot in my ear, and other noodle tales (An I can read book)",1982,6,0,1,1981,1
alvin schwartz,Scary Stories Treasury: Omnibus,1985,7,4,2,1982,3
alvin schwartz,"In a Dark, Dark Room and Other Scary Stories",1985,8,2.875,8,1985,0
alvin schwartz,There Is a Carrot in My Ear and Other Noodle Tales,1986,9,1.2,5,1985,1
alvin schwartz,More Scary Stories To Tell In The Dark,1986,10,3.5238095238095237,21,1986,0
alvin schwartz,Scary Stories to Tell in the Dark : Collected from American Folklore (Scary Stories),1986,11,3.4285714285714284,21,1986,0
alvin schwartz,"Telling Fortunes: Love Magic, Dream Signs, and Other Ways to Learn the Future",1987,12,6,1,1986,1
alvin schwartz,Fat Man in a Fur Coat and Other Bear Stories,1987,13,0,1,1987,0
alvin schwartz,Ghosts! Ghostly Tales from Folklore,1991,14,0,1,1987,4
alvin schwartz,Scary Stories 3 : More Tales to Chill Your Bones (Scary Stories),1991,15,4,2,1991,0
alvin schwartz,Scary Stories 3 : More Tales to Chill Your Bones (Scary Stories),1991,16,2.0555555555555554,18,1991,0
alvin schwartz,And the Green Grass Grew All Around: Folk Poetry from Everyone,1992,17,1,1,1991,1
alvin schwartz,"Cross Your Fingers, Spit in Your Hat: Superstitions and Other Beliefs",1993,18,0,2,1992,1
alvin schwartz,"Ghosts!:  Ghostly Tales from Folklore  (An I Can Read Book, Level 2)",1993,19,0,2,1993,0
alvin schwartz,Ghosts! Ghostly Tales from Folklore,1993,20,0,1,1993,0
alyce faye cleese,How to Manage Your Mother: Ten Steps to a Better Relationship,2000,2,2,1,2000,0
ama ata aidoo,Our Sister Killjoy (African Classics),1997,2,1,1,1993,4
amanda christie,"Eine himmlische Familie, Matt, der Herzensbrecher",2000,2,9,1,2000,0
amanda christie,Mr. Nice Guy (7th Heaven),2000,3,3.5,2,2000,0
amanda quick,Surrender,1990,2,2.857142857142857,28,1990,0
amanda quick,Scandal,1991,3,4.473684210526316,19,1990,1
amanda quick,Rendezvous,1991,4,4.130434782608695,23,1991,0
amanda quick,Reckless,1992,5,4.482758620689655,29,1991,1
amanda quick,Ravished,1992,6,4.1,20,1992,0
amanda quick,Dangerous,1993,7,2.36,25,1992,1
amanda quick,Deception,1993,8,0,1,1993,0
amanda quick,Desire,1994,9,4.5,20,1993,1
amanda quick,Deception,1994,10,2.2058823529411766,34,1994,0
amanda quick,Mistress,1994,11,7,2,1994,0
amanda quick,Mistress,1995,12,2.272727272727273,33,1994,1
amanda quick,Mystique,1995,13,3.3333333333333335,6,1995,0
amanda quick,Mystique,1995,14,7,1,1995,0
amanda quick,Mystique,1996,15,1.619047619047619,21,1995,1
amanda quick,Mischief,1996,16,6,3,1996,0
amanda quick,Affair,1997,17,2.25,4,1996,1
amanda quick,Mischief,1997,18,2.9583333333333335,24,1997,0
amanda quick,With This Ring,1998,19,1.75,4,1997,1
amanda quick,Affair,1998,20,2.962962962962963,27,1998,0
amanda quick,With This Ring,1999,21,1.696969696969697,33,1998,1
amanda quick,I Thee Wed,1999,22,3.2,5,1999,0
amanda quick,I Thee Wed,2000,23,4.217391304347826,23,1999,1
amanda quick,Wicked Widow,2000,24,3.4,5,2000,0
amanda quick,Mischief,2000,25,9,1,2000,0
amanda quick,Wicked Widow,2001,26,2.259259259259259,27,2000,1
amanda quick,Slightly Shady,2001,27,3.6363636363636362,11,2001,0
amanda quick,Slightly Shady,2002,28,1.65,40,2001,1
amanda quick,Don't Look Back,2002,29,4.5,2,2002,0
amanda quick,Late for the Wedding,2003,30,3.111111111111111,9,2002,1
amanda quick,Un Pasado Sombrio,2003,31,8,1,2003,0
amanda quick,Don't Look Back,2003,32,1.911764705882353,34,2003,0
amanda quick,The Paid Companion,2004,33,5,5,2003,1
american bible society staff,Holy Bible With Deuterocanonicals/Apocrypha: Contemporary English Version,2000,2,10,1,1999,1
american kennel club,American Kennel Club Dog Care and Training,1991,2,6,2,1985,6
american sport education program,Coaching Youth Softball,1996,2,0,2,1995,1
amii lorin,Candleglow,1984,2,4.5,2,1982,2
amii lorin,Night Striker (Candlelight Ecstasy Supreme),1985,3,0,1,1984,1
amii lorin,"Morning Rose, Evening Savage",1994,4,0,2,1985,9
amram ducovny,Coney: A Novel,2001,2,6,1,2000,1
amy dean,Once upon a Time: Stories of Hope from Adult Children,1988,2,9,1,1986,2
amy dean,Lifegoals: Setting &amp; Achieving Goals to Chart the Course of Your Life/123,1991,3,0,1,1988,3
amy dean,Night Light (Hazelden Meditation Series),1996,4,4.333333333333333,3,1991,5
amy dean,Daybreak: 52 Things Nature Teaches Us : Lessons for Seeking the Natural Element in Everyday Life,1996,5,9,1,1996,0
amy ehrlich,Bunnies at Christmastime,1989,2,8,1,1982,7
amy ehrlich,Bunnies and Their Grandma (Pied Piper Book),1989,3,0,1,1989,0
amy ehrlich,Bunnies on Their Own (Pied Piper Paperbacks),1992,4,9,1,1989,3
amy ehrlich,"Parents in the Pigpen, Pigs in the Tub",1993,5,9,1,1992,1
amy ehrlich,When I Was Your Age: Original Stories About Growing Up (When I Was Your Age),1996,6,2.3333333333333335,3,1993,3
amy ehrlich,Joyride,2001,7,7,1,1996,5
amy keating rogers,"Powerpuff Professor (Powerpuff Girls Chapter Book, 1)",2000,2,2.5,2,2000,0
amy macdonald,No More Nice,1996,2,4,2,1993,3
amy macdonald,Little Beaver and the Echo,1998,3,6,1,1996,2
amy macdonald,No More Nice,1998,4,0,1,1998,0
amy macdonald,Little Beaver and the Echo,1999,5,4.5,2,1998,1
amy myers,Murder in Pug's Parlour,1992,2,0,1,1992,0
amy myers,Murder at Plum's,1993,3,7,1,1992,1
amy myers,Murder Makes an Entree: A Victorian Whodunit,1996,4,4,1,1993,3
amy myers,Murder At Plums,1999,5,0,3,1996,3
amy myers,Tom Dickens und die Geliebte des Malers.,2001,6,0,2,1999,2
amy tan,The Joy Luck Club (Vintage Contemporaries),1991,2,2,23,1989,2
amy tan,The Kitchen God's Wife,1991,3,4.212121212121212,33,1991,0
amy tan,The Joy Luck Club,1991,4,2.35,20,1991,0
amy tan,The Kitchen God's Wife,1991,5,0,1,1991,0
amy tan,The Kitchen God's Wife (Thorndike Large Print Basic Series),1992,6,0,1,1991,1
amy tan,The Kitchen God's Wife,1992,7,2.6666666666666665,3,1992,0
amy tan,The Kitchen God's Wife,1992,8,2.8754578754578755,273,1992,0
amy tan,The Moon Lady,1992,9,10,1,1992,0
amy tan,TÃ?Â¶chter des Himmels. Roman.,1992,10,3.066666666666667,15,1992,0
amy tan,Kitchen God's Wife (Thorndike Paperback Bestsellers),1992,11,4,2,1992,0
amy tan,The Kitchen God's Wife (Vintage Contemporaries),1993,12,4.923076923076923,13,1992,1
amy tan,Die Frau des Feuergottes. Roman.,1993,13,3.1666666666666665,6,1993,0
amy tan,The Joy Luck Club,1994,14,3.6875,16,1993,1
amy tan,The Joy Luck Club,1994,15,3.0635838150289016,519,1994,0
amy tan,The Chinese Siamese Cat,1994,16,10,1,1994,0
amy tan,The Hundred Secret Senses,1995,17,2.891566265060241,83,1994,1
amy tan,The Hundred Secret Senses,1995,18,0,2,1995,0
amy tan,Hundred Secret Senses Limited Ed.,1995,19,0,4,1995,0
amy tan,The Moon Lady (Aladdin Picture Books),1995,20,10,2,1995,0
amy tan,El Club De LA Buena Estrella,1995,21,6.5,2,1995,0
amy tan,Kitchen Gods Wife (Cliffs Notes),1996,22,0,1,1995,1
amy tan,The Hundred Secret Senses,1996,23,8,2,1996,0
amy tan,The Hundred Secret Senses,1996,24,2.8991228070175437,228,1996,0
amy tan,The Hundred Secret Senses,1998,25,1.7222222222222223,18,1996,2
amy tan,Die hundert verborgenen Sinne.,1998,26,1.6,5,1998,0
amy tan,The Best American Short Stories 1999,1999,27,2.6666666666666665,3,1998,1
amy tan,"The Best American Short Stories 1999 (Best American Short Stories, 1999)",1999,28,4,14,1999,0
amy tan,The Hundred Secret Senses,2000,29,0,2,1999,1
amy tan,The Bonesetter's Daughter,2001,30,3.5,2,2000,1
amy tan,"Sagwa, The Chinese Siamese Cat",2001,31,10,1,2001,0
amy tan,The Bonesetter's Daughter,2001,32,3.358974358974359,117,2001,0
amy tan,The Bonesetter's Daughter,2001,33,1.3333333333333333,6,2001,0
amy tan,LA Hija Del Curandero,2001,34,2.6666666666666665,3,2001,0
amy tan,Bonesetter's Daughter,2001,35,1.5555555555555556,9,2001,0
amy tan,The Hundred Secret Senses,2001,36,3,1,2001,0
amy tan,LA Esposa Del Dios Del Fuego,2001,37,7,1,2001,0
amy tan,The Bonesetter's Daughter,2001,38,4.5,2,2001,0
amy tan,El Club de La Buena Estrella,2001,39,8,1,2001,0
amy tan,LA Hija Del Curandero,2002,40,1.1428571428571428,7,2001,1
amy tan,Los Cien Sentidos Secretos,2002,41,7,1,2002,0
amy tan,The Kitchen God's Wife,2002,42,0,1,2002,0
amy tan,El Club De La Buena Estrella,2002,43,7.5,2,2002,0
amy tan,La Esposa Del Dios Del Fuego,2002,44,6,1,2002,0
amy tan,"Club de la buena estrella (Debolsillo, 338/1)",2002,45,5.5,4,2002,0
amy tan,Il Circolo Della Fortuna E Della Felicita,2002,46,0.7142857142857143,7,2002,0
amy tan,Hija del curandero,2002,47,3,2,2002,0
amy tan,The Bonesetter's Daughter,2002,48,3.443579766536965,257,2002,0
amy tan,The Opposite of Fate: A Book of Musings,2003,49,3.4166666666666665,12,2002,1
amy tan,The Bonesetter's Daughter (Ballantine Reader's Circle),2003,50,3.1,20,2003,0
anatoly shcharansky,Fear No Evil: The Classic Memoir of One Man's Triumph over a Police State,1998,2,0,1,1990,8
andre aciman,Out of Egypt: A Memoir,1996,2,0,2,1994,2
andre aciman,Out of Egypt,1997,3,0,1,1996,1
andre aciman,False Papers,2000,4,0,1,1997,3
andre iii dubus,The Cage Keeper : And Other Stories (Vintage Contemporaries (Paperback)),2001,2,0,2,1994,7
andre iii dubus,The House of Sand and Fog (Vintage Contemporaries (Paperback)),2003,3,3.0833333333333335,24,2001,2
andrea chesman,The Vegetarian Grill: 200 Recipes for Inspired Flame-Kissed Meals,1998,2,7,1,1985,13
andrea chesman,"366 Delicious Ways to Cook Rice, Beans, and Grains",1998,3,7,2,1998,0
andrea chesman,Salad Suppers,1999,4,5,1,1998,1
andrea urton,"Mind Boggles: Puzzles, Riddles, and Tricks to Blow Your Mind!",1994,2,0,2,1993,1
andrea van steenhouse,A Woman's Guide to a Simpler Life,1997,2,4.666666666666667,3,1996,1
andreas,El conocimiento secreto de Jesucristo,2004,2,0,2,2003,1
andrei makine,Dreams Of My Russian Summers: A Novel,1998,2,1.72,25,1997,1
andrei makine,Once Upon the River Love,1998,3,9,1,1998,0
andrei makine,"Diana-TaschenbÃ?Â¼cher, Nr.16, Das franzÃ?Â¶sische Testament",1999,4,1.75,4,1998,1
andrei makine,Le Testament Francais,1999,5,0,2,1999,0
andrei makine,The Crime of Olga Arbyelina,1999,6,7,1,1999,0
andrei makine,Confessions of a Fallen Standard-Bearer,2001,7,0,1,1999,2
andrei makine,The Crime of Olga Arbyrlina,2001,8,0,1,2001,0
andrei makine,Die Liebe am FluÃ?Â? Amur. Sonderausgabe.,2001,9,0,2,2001,0
andrei makine,El Testamento Frances,2002,10,6,1,2001,1
andrei makine,LA Musica De Una Vida,2002,11,8,1,2002,0
andrei makine,The Music of a Life : A Novel,2002,12,4.5,2,2002,0
andrew crumey,"Music, in a Foreign Language",1997,2,0,1,1996,1
andrew crumey,D'Alembert's Principle : A Novel In Three Panels,1998,3,6,1,1997,1
andrew crumey,Mr. Mee,2001,4,2.6666666666666665,3,1998,3
andrew crumey,Mr. Mee : A Novel,2002,5,4.75,4,2001,1
andrew davenport,Teletubbies Coloring Activity Book: Come and Play,1998,2,5,1,1998,0
andrew davenport,It's Tubby Bedtime (Teletubbies),1999,3,0.7142857142857143,7,1998,1
andrew davenport,This Little Teletubby,1999,4,0,2,1999,0
andrew davenport,Dancing With the Skirt (Teletubbies),1999,5,0,2,1999,0
andrew davenport,"Merry Christmas, Teletubbies! (Teletubbies)",1999,6,0,1,1999,0
andrew gibson,"Jemima, Grandma and the Great Lost Zone",1992,2,0,1,1991,1
andrew gibson,Chegwith Skillet Escapes,1996,3,1.5,2,1992,4
andrew gurr,William Shakespeare: The Extraordinary Life of the Most Successful Writer of All Time,1996,2,8,1,1989,7
andrew gurr,A Little Piece of England,2001,3,0,1,1996,5
andrew h. vachss,Blue Belle,1988,2,0,2,1987,1
andrew h. vachss,Strega,1988,3,1.8,5,1988,0
andrew h. vachss,Blossom,1990,4,5.5,2,1988,2
andrew h. vachss,Hard Candy,1990,5,3,3,1990,0
andrew h. vachss,Blossom,1991,6,2,4,1990,1
andrew h. vachss,Sacrifice,1991,7,3.3333333333333335,3,1991,0
andrew h. vachss,Sacrifice,1992,8,2.8181818181818183,11,1991,1
andrew h. vachss,Shella,1993,9,2.8333333333333335,6,1992,1
andrew h. vachss,Another Chance to Get It Right,1993,10,10,2,1993,0
andrew h. vachss,Born Bad: Stories (Vintage Crime/Black Lizard),1994,11,0,5,1993,1
andrew h. vachss,Down in the Zero,1994,12,9,1,1994,0
andrew h. vachss,Batman: The Ultimate Evil,1995,13,1.5,6,1994,1
andrew h. vachss,Blue Belle,1995,14,7,1,1995,0
andrew h. vachss,Footsteps of the Hawk,1995,15,0,1,1995,0
andrew h. vachss,Down in the Zero (Vintage Crime/Black Lizard),1995,16,0,3,1995,0
andrew h. vachss,False Allegations,1996,17,0,1,1995,1
andrew h. vachss,Footsteps of the Hawk,1996,18,2.6666666666666665,3,1996,0
andrew h. vachss,Batman: The Ultimate Evil,1996,19,3,2,1996,0
andrew h. vachss,Sacrifice,1996,20,7,1,1996,0
andrew h. vachss,Blossom (Vintage Crime/Black Lizard),1996,21,0,2,1996,0
andrew h. vachss,False Allegations (Vintage Crime/Black Lizard),1997,22,5.6,5,1996,1
andrew h. vachss,Flood (Vintage Crime/Black Lizard),1998,23,10,1,1997,1
andrew h. vachss,Safe House,1998,24,6,1,1998,0
andrew h. vachss,Safe House (Vintage Crime/Black Lizard),1999,25,8.5,2,1998,1
andrew h. vachss,Safe House Open Market Edition,1999,26,6,1,1999,0
andrew h. vachss,Everybody Pays: Stories (Vintage Crime/Black Lizard),1999,27,0,1,1999,0
andrew h. vachss,Choice of Evil (Burke Novels),1999,28,7,2,1999,0
andrew h. vachss,Dead and Gone (Burke Novels),2000,29,6.666666666666667,3,1999,1
andrew h. vachss,Shella,2000,30,2.6666666666666665,3,2000,0
andrew h. vachss,Choice of Evil (Vintage Crime/Black Lizard),2000,31,4.5,4,2000,0
andrew h. vachss,Pain Management: A Burke Novel,2001,32,2.8333333333333335,6,2000,1
andrew j. offutt,King dragon,1980,2,0,3,1979,1
andrew j. offutt,The Tower of Death (Cormac Mac Art Series),1982,3,0,1,1980,2
andrew j. offutt,The Sign of the Moonbow: Cormac Mac Art No 7 (Cormac Macart),1984,4,0,1,1982,2
andrew j. offutt,"The Mists of Doom (Cormac Mac Art Series, No 1)",1984,5,0,1,1984,0
andrew j. offutt,Swords Against Darkness (Swords Against Darkness),1990,6,0,2,1984,6
andrew j. offutt,The Shadow of Sorcery,1993,7,4.5,2,1990,3
andrew mark,Falling Bodies,2000,2,1.8846153846153846,26,1999,1
andrew martin,The Necropolis Railway,2002,2,7,2,1999,3
andrew roberts,Churchill und seine Zeit.,1998,2,0,1,1995,3
andrew schwebel,"A Guide to a Happier Family: Overcoming the Anger, Frustration, and Boredom That Destroy Family Life",1990,2,6,1,1990,0
andrew swanfeldt,Crossword Puzzle Dictionary : Sixth Edition,1994,2,9.5,2,1991,3
andrew todhunter,A Meal Observed,2004,2,0,1,2001,3
andrew young,An Easy Burden: The Civil Rights Movement and the Transformation of America,1996,2,4.5,2,1994,2
andrã?â© brink,Une saison blanche et sÃ?Â¨che,1982,2,0,3,1978,4
andy baggott,Die Weisheit der Kelten.,2002,2,8,1,2000,2
andy behrman,Electroboy : A Memoir of Mania,2003,2,4.5,2,2002,1
andy bellin,"Poker Nation: A High-Stakes, Low-Life Adventure into the Heart of a Gambling Country",2003,2,0,1,2002,1
andy collins,The Draconomicon (Dungeons &amp; Dragons),2003,2,0,1,2002,1
andy collins,Complete Warrior (Dungeons &amp; Dragons Accessory),2003,3,8,1,2003,0
andy collins,Unearthed Arcana (Dungeons &amp; Dragons),2004,4,5,1,2003,1
andy edmonds,"""Frame-Up!: The Shocking Scandal That Destroyed Hollywood's Biggest Comedy Star Roscoe \Fatty"""" Arbuckle""""""",1992,2,4.5,2,1991,1
andy griffiths,The Day My Bum Went Psycho,2002,2,0,1,2001,1
andy griffiths,Zombie Bums From Uranus,2003,3,3.25,4,2002,1
andy griffiths,Just Annoying!,2003,4,8.5,2,2003,0
andy griffiths,Day My Butt Went Psycho,2003,5,1.7142857142857142,14,2003,0
andy griffiths,Just Joking!,2003,6,0,1,2003,0
andy griffiths,Rock Drumming (Progressive Young Beginners),2004,7,0,1,2003,1
andy griffiths,Zombie Butts From Uranus!,2004,8,0,1,2004,0
andy mangels,"Beyond Mulder and Scully: The Mysterious Characters of \the X-Files""""""""",1997,2,0,2,1995,2
andy mangels,Section 31:  Rogue (Star Trek The Next Generation),2001,3,4.444444444444445,9,1997,4
andy mangels,Skeletons in the Closet,2002,4,0,5,2001,1
andy mangels,Turnabout (Roswell Series),2003,5,4,2,2002,1
andy mangels,Pursuit,2003,6,0,2,2003,0
anees jung,Breaking the Silence: Voices of Women from Around the World,1997,2,0,1,1987,10
angel milan,"Out of Bounds (Silhouette Desire, 118)",1984,2,10,1,1982,2
angel milan,"Anna'S Child (Silhouette Desire, No 226)",1985,3,4,2,1984,1
angel milan,Sugarfire,1985,4,0,3,1985,0
angela elwell hunt,The Much Adored Sandy Shore (Cassie Perkins),1992,2,0,1,1992,0
angela elwell hunt,"The Chance of a Lifetime (Cassie Perkins, No 8)",1993,3,6,1,1992,1
angela elwell hunt,"The Secret of Cravenhill Castle (The Nicki Holland Mysteries, No 8)",1993,4,0,3,1993,0
angela elwell hunt,"Star Light, Star Bright (Cassie Perkins, No 7)",1993,5,0,1,1993,0
angela elwell hunt,Roanoke: The Lost Colony (Keepers of the Ring #1),1996,6,0,1,1993,3
angela elwell hunt,"The Deadly Chase (Hunt, Angela Elwell, Colonial Captives, Bk. 2.)",1996,7,0,2,1996,0
angela elwell hunt,"Dreamers (Legacies of the Ancient River, 1)",1996,8,2.6,10,1996,0
angela elwell hunt,The Proposal,1996,9,2.5,4,1996,0
angela elwell hunt,Journey (Legacies of the Ancient River),1997,10,4,2,1996,1
angela elwell hunt,Brothers (Legacies of the Ancient River),1997,11,4.5,2,1997,0
angela elwell hunt,"The Silver Sword (The Heirs of Cahira O'Connor , No 1)",1998,12,0,1,1997,1
angela elwell hunt,Dreamers (Five Star Christian Fiction),1998,13,0,1,1998,0
angela elwell hunt,The Immortal,2000,14,0,7,1998,2
angela elwell hunt,The Note - A Novel -,2001,15,5.052631578947368,19,2000,1
angela elwell hunt,Then Comes Marriage,2001,16,9,1,2001,0
angela elwell hunt,The Shadow Women,2002,17,3.8,5,2001,1
angela elwell hunt,The Justice,2002,18,0,1,2002,0
angela elwell hunt,The Canopy,2003,19,10,1,2002,1
angela elwell hunt,The Pearl (Women of Faith Fiction),2003,20,2.25,4,2003,0
angela elwell hunt,The Shadow Women,2003,21,10,1,2003,0
angela elwell hunt,The Awakening,2004,22,0,1,2003,1
angela elwell hunt,"The Debt : The Story of a Past Redeemed (Hunt, Angela Elwell)",2004,23,0,1,2004,0
angela elwell hunt,The Tale of Three Trees: A Traditional Folktale,2004,24,7.5,4,2004,0
angela hausner,"DenkanstÃ?Â¶Ã?Â?e 2003. Ein Lesebuch aus Philosophie, Kultur und Wissenschaft.",2002,2,1,2,2001,1
angela knight,The Forever Kiss,2004,2,10,1,2004,0
anita brookner,Look at Me,1983,2,5,1,1981,2
anita brookner,Providence,1984,3,0,3,1983,1
anita brookner,A Start in Life,1984,4,8,1,1984,0
anita brookner,Look at Me,1985,5,1.1666666666666667,6,1984,1
anita brookner,Family and Friends,1985,6,3.5,2,1985,0
anita brookner,Hotel Du Lac,1985,7,2.142857142857143,7,1985,0
anita brookner,The debut,1985,8,0,4,1985,0
anita brookner,Family and Friends,1986,9,0,1,1985,1
anita brookner,Hotel Du Lac,1986,10,1.75,4,1986,0
anita brookner,The Misalliance,1987,11,5.333333333333333,3,1986,1
anita brookner,The Misalliance: A Novel,1988,12,0,3,1987,1
anita brookner,Friend from England,1988,13,7,1,1988,0
anita brookner,A Friend from England,1988,14,0,1,1988,0
anita brookner,Hotel Du Lac,1988,15,0,1,1988,0
anita brookner,Latecomers,1989,16,3.5,2,1988,1
anita brookner,The Debut,1990,17,0,4,1989,1
anita brookner,Latecomers (Vintage Contemporaries),1990,18,0,5,1990,0
anita brookner,Lewis Percy (Vintage Contemporaries),1991,19,7,1,1990,1
anita brookner,Brief Lives (Vintage Contemporaries),1992,20,0,7,1991,1
anita brookner,Fraud,1993,21,0,2,1992,1
anita brookner,A Closed Eye (Vintage Contemporaries),1993,22,1.75,4,1993,0
anita brookner,Providence (Vintage Contemporaries),1994,23,4,7,1993,1
anita brookner,Fraud (Vintage Contemporaries),1994,24,2.6666666666666665,6,1994,0
anita brookner,Dolly,1994,25,3.5,2,1994,0
anita brookner,Hotel Du Lac (Vintage Contemporaries),1995,26,1.9166666666666667,12,1994,1
anita brookner,Dolly,1995,27,1.8571428571428572,7,1995,0
anita brookner,A Private View,1995,28,0,1,1995,0
anita brookner,MÃ?Â©salliance,1996,29,3.5,2,1995,1
anita brookner,A Private View (Vintage Contemporaries),1996,30,0,3,1996,0
anita brookner,Verlorene WÃ?Â¼nsche.,1997,31,0,1,1996,1
anita brookner,Incidents in the Rue Laugier (Vintage Contemporaries),1997,32,0,4,1997,0
anita brookner,HÃ?Â´tel du Lac,1997,33,0,1,1997,0
anita brookner,Look at Me (Vintage Contemporaries),1997,34,1.1428571428571428,7,1997,0
anita brookner,Visitors : A Novel,1998,35,2.25,4,1997,1
anita brookner,Look at Me (Isis),1998,36,8,1,1998,0
anita brookner,Altered States (Vintage Contemporaries),1998,37,8,2,1998,0
anita brookner,Visitors,1998,38,4,2,1998,0
anita brookner,Family and Friends (Vintage Contemporaries),1998,39,0,1,1998,0
anita brookner,Undue Influence,2000,40,0,3,1998,2
anita brookner,Falling Slowly,2000,41,1.8333333333333333,6,2000,0
anita brookner,Undue Influence: A Novel (Vintage Contemporaries),2001,42,2.6666666666666665,3,2000,1
anita brookner,The Bay of Angels,2001,43,0,3,2001,0
anita brookner,Familia Y Amigos,2002,44,7,1,2001,1
anita brookner,The Next Big Thing,2002,45,3,2,2002,0
anita brookner,Hotel Du Lac (Andanzas),2002,46,7,1,2002,0
anita brookner,The Bay of Angels: A Novel,2002,47,0,1,2002,0
anita brookner,The Rules of Engagement : A Novel (Brookner Anita),2003,48,3,2,2002,1
anita brookner,Making Things Better,2004,49,0,1,2003,1
anita brookner,The Bay of Angels,2004,50,8,1,2004,0
anita bunkley,Relative Interest,2003,2,10,1,1999,4
anita loos,'Gentlemen Prefer Blondes' 'but Gentlemen Marry Brunettes',1983,2,0,1,1974,9
anita loos,Gentlemen Prefer Blondes: The Illuminating Diary of a Professional Lady (Penguin Twentieth-Century Classics),1994,3,8,1,1983,11
anita loos,Gentlemen Prefer Blondes: The Illuminating Diary of a Professional Lady,1998,4,3,2,1994,4
anita loos,Gentlemen Prefer Blondes -and- But Gentlemen Marry Brunettes: The Illuminating Diary of a Professional Lady,1998,5,8,1,1998,0
anita stansfield,"First Love, Second Chances: A Novel",1995,2,4.333333333333333,3,1994,1
anita stansfield,A Christmas Melody,1998,3,10,1,1995,3
anita stansfield,The Three Gifts of Christmas: A Novel (Christmas Books),1999,4,0,1,1998,1
anita stansfield,A Star in Winter: A Novel,2000,5,3.3333333333333335,3,1999,1
anita stansfield,Someone to Hold,2002,6,4,2,2000,2
anitra sheen,Things Unspoken,2001,2,3.5,2,1999,2
anjana appachana,Listening Now,1998,2,0,1,1992,6
ann ashford,If I Found a Wistful Unicorn,1994,2,10,1,1992,2
ann ashford,If I Found a Wistful Unicorn: A Gift of Love,2002,3,9,1,1994,8
ann brandt,Melodie eines Sommers.,2001,2,0,1,2000,1
ann c. fallon,WHERE DEATH LIES,1991,2,0,4,1990,1
ann c. fallon,Dead Ends,1992,3,0,3,1991,1
ann c. fallon,HOUR OF OUR DEATH : HOUR OF OUR DEATH,1995,4,0,3,1992,3
ann c. fallon,Deadly Analysis (James Fleming Mysteries),2000,5,0,2,1995,5
ann cameron,"Stories Julian Tells (Stepping Stone,  paper)",1989,2,0,4,1987,2
ann cameron,The Most Beautiful Place in the World,1993,3,0,1,1989,4
ann cameron,The Secret Life of Amanda K. Woods,1999,4,0,1,1993,6
ann cameron,The Stories Julian Tells,1999,5,9,1,1999,0
ann charters,Kerouac,1979,2,10,1,1973,6
ann charters,The Story and its writer: An introduction to short fiction,1983,3,7,2,1979,4
ann charters,"Beats: Literary Bohemians in Postwar America (Dictionary of Literary Biography, V. 16)",1983,4,10,1,1983,0
ann charters,The Portable Beat Reader (Viking Portable Library),1992,5,2.5833333333333335,12,1983,9
ann charters,Kerouac: A Biography,1994,6,1.6666666666666667,3,1992,2
ann charters,The Story and Its Writer: An Introduction to Short Fiction,1995,7,0,1,1994,1
ann goethe,Midnight Lemonade,1994,2,0,2,1993,1
ann landers,"Wake Up and Smell the Coffee!: Advice, Wisdom, and Uncommon Good Sense",1996,2,0,3,1983,13
ann landers,The Best of Ann Landers: Her Favorite Letters of All Time,1997,3,0,1,1996,1
ann marie sabath,Business Etiquette: 101 Ways to Conduct Business With Charm and Savvy,1997,2,0,1,1993,4
ann maxwell,Forget Me Not,1984,2,0,2,1982,2
ann maxwell,Timeshadow Rider,1986,3,0,1,1984,2
ann maxwell,Fire Dancer,1995,4,0,1,1986,9
ann maxwell,Dancer's Illusion,1996,5,0,1,1995,1
ann maxwell,Change,1996,6,1.2,5,1996,0
ann maxwell,Timeshadow Rider,1997,7,0,4,1996,1
ann maxwell,Shadow and Silk,1997,8,3.2,5,1997,0
ann mcpherson,The Diary of the Other Health Freak,1996,2,5.666666666666667,3,1991,5
ann mcpherson,The Diary of the Other Health Freak,2002,3,5,2,1996,6
ann morris,"Hats, Hats, Hats (Around the World Series)",1993,2,3.5,2,1990,3
ann morris,Little Ballerinas (Grosset &amp; Dunlap All Aboard Book),1997,3,3.5,2,1993,4
ann raimes,Keys for Writers Exercises,1995,2,9,1,1995,0
ann raimes,Writing Arguments,1996,3,0,1,1995,1
ann raimes,Pocket Keys for Writers,2000,4,0,1,1996,4
ann schweninger,The Mother Goose Word Book (Golden Sturdy Book),1987,2,3.3333333333333335,3,1981,6
ann schweninger,Birthday Wishes (Picture Puffin S.),1988,3,3.5,2,1987,1
ann schweninger,Off to School (Picture Puffin S.),1989,4,5,1,1988,1
ann thwaite,The Brilliant Career of Winnie-the-Pooh: The Story of A.A. Milne and His Writing for Children,1992,2,0,1,1991,1
ann ward radcliffe,The Mysteries of Udolpho (Oxford World's Classics),1998,2,5,3,1980,18
ann ward radcliffe,The Romance of the Forest (Oxford World's Classics),1999,3,3,3,1998,1
ann-marie macdonald,Fall on Your Knees,1996,2,3,2,1990,6
ann-marie macdonald,Fall on Your Knees,1997,3,3.5454545454545454,22,1996,1
ann-marie macdonald,"Fall on Your Knees (Oprah's Book Club (St. Paul, Minn.).)",2002,4,10,1,1997,5
ann-marie macdonald,Fall On Your Knees (Oprah #45),2002,5,3.387323943661972,284,2002,0
ann-marie macdonald,Fall on Your Knees (Oprah's Book Club),2002,6,2.533333333333333,45,2002,0
ann-marie macdonald,Fall on Your Knees,2002,7,4.694444444444445,36,2002,0
ann-marie macdonald,Fall on Your Knees (Wheeler Hardcover),2002,8,0,1,2002,0
ann-marie macdonald,The Way the Crow Flies: A Novel (Today Show Book Club #18),2003,9,2.1666666666666665,18,2002,1
ann-marie macdonald,The Way the Crow Flies : A Novel,2004,10,4,2,2003,1
anna clarke,Cabin 3033,1989,2,0,1,1989,0
anna clarke,My Search for Ruth,1989,3,5,1,1989,0
anna clarke,The Deathless and the Dead,1989,4,7,1,1989,0
anna clarke,Last Voyage,1990,5,3.5,2,1989,1
anna clarke,Murder in Writing,1990,6,5,2,1990,0
anna clarke,The Darkened Room,1991,7,6,1,1990,1
anna clarke,Legacy of Evil,1991,8,0.5,4,1991,0
anna clarke,The Whitelands Affair,1992,9,0,2,1991,1
anna clarke,Poison Parsley,1992,10,5,1,1992,0
anna clarke,The Case of the Paranoid Patient,1993,11,0,1,1992,1
anna jeffrey,The Love of a Stranger,2004,2,4,6,2003,1
anna jennet,Fire,1995,2,0,1,1993,2
anna jennet,My Lady Captor,1996,3,0,1,1995,1
anna johnson,Three Black Skirts : All You Need To Survive,2000,2,8,1,2000,0
anna johnson,Handbags: The Power of the Purse,2002,3,0,2,2000,2
anna kirwan,"Juliet : Rescue at Marlehead Manor (Girlhood Journeys Book , No 2)",1997,2,8,1,1996,1
anna kirwan,"Victoria: May Blossom of Britannia, England, 1829 (The Royal Diaries)",2001,3,2.857142857142857,7,1997,4
anna lee waldo,Prairie: The Legend of Charles Burton Irwin and the Y6 Ranch,1987,2,1,2,1986,1
anna lee waldo,Circle of Stones,1999,3,9,1,1987,12
anna lee waldo,Prairie: The Legend of Charles Burton Irwin and the Y6 Ranch,2000,4,0,1,1999,1
anna lee waldo,Circle of Stones,2000,5,1.8387096774193548,31,2000,0
anna lee waldo,Ring der Steine.,2001,6,9,1,2000,1
anna lee waldo,Circle of Stars,2001,7,4.5,2,2001,0
anna lee waldo,Ring der Steine.,2002,8,6,1,2001,1
anna lee waldo,Circle of Stars,2002,9,5.2,5,2002,0
anna maria ortese,Corps cÃ?Â©leste,2000,2,0,1,1997,3
anna maria sigmund,Die Frauen der Nazis.,2000,2,1.6666666666666667,3,2000,0
anna maxted,Getting over It,2000,2,4.111111111111111,9,1999,1
anna maxted,Getting Over It,2001,3,2.775,80,2000,1
anna maxted,Running in Heels: A Novel,2001,4,2.8947368421052633,19,2001,0
anna maxted,Running In Heels: A Novel,2002,5,3.1142857142857143,35,2001,1
anna maxted,Behaving Like Adults : A Novel,2003,6,2,11,2002,1
anna maxted,Being Committed : A Novel,2004,7,0,2,2003,1
anna maxted,Behaving Like Adults : A Novel,2004,8,0,1,2004,0
anna murdoch,Family Business,1989,2,0,3,1988,1
anna murdoch,Coming to Terms: A Novel,1991,3,0,1,1989,2
anna murdoch,Coming to Terms,1992,4,0,1,1991,1
anna pavord,Tulip,2001,2,2.6,10,2000,1
anna-karin palm,Der Faun.,2002,2,3,6,2001,1
anne armstrong thompson,ROMANOFF RANSOM,1978,2,0,1,1975,3
anne birk,Scherbengericht.,2002,2,0,1,1989,13
anne bronte,The Tenant of Wildfell Hall (Banquo Books),1979,2,0,1,1971,8
anne bronte,Complete Poems of Anne Bronte,1988,3,5,1,1979,9
anne bronte,Agnes Grey (Penguin Classics),1989,4,5,2,1988,1
anne bronte,Agnes Grey (The World's Classics),1991,5,2,2,1989,2
anne bronte,Die Herrin von Wildfell Hall. Roman.,1993,6,10,1,1991,2
anne bronte,The Tenant of Wildfell Hall (The World's Classics),1993,7,0,4,1993,0
anne bronte,Tenant of Wildfell Hall (English Library),1993,8,3.5714285714285716,7,1993,0
anne bronte,Agnes Grey (Penguin Popular Classics),1994,9,2.6666666666666665,3,1993,1
anne bronte,The Tenant of Wildfell Hall (Penguin Popular Classics),1994,10,4.461538461538462,13,1994,0
anne bronte,The Tenant of Wildfell Hall (Penguin Classics),1996,11,3.2857142857142856,7,1994,2
anne bronte,The Tenant of Wildfell Hall (Oxford World's Classics),1998,12,8,6,1996,2
anne bronte,Tenant of Wildfell Hall (Wordsworth Collection),1998,13,3,3,1998,0
anne bronte,Agnes Grey (Oxford World's Classics),1998,14,1.5,4,1998,0
anne bronte,Tenant of Wildfell Hall (Wordsworth Classics),1999,15,4.2,5,1998,1
anne bronte,Agnes Grey,2000,16,8,1,1999,1
anne edwards,VIVIEN LEIGH BIO,1978,2,2.5,6,1977,1
anne edwards,Road to Tara,1984,3,0,1,1978,6
anne edwards,REMARKABLE WOMAN,1986,4,0,6,1984,2
anne edwards,Katharine Hepburn: A Biography,1987,5,0,1,1986,1
anne edwards,Shirley Temple: American Princess,1988,6,9,1,1987,1
anne edwards,A Remarkable Woman: A Biography of Katharine Hepburn,1989,7,3,3,1988,1
anne edwards,Shirley Temple: American Princess,1989,8,0,4,1989,0
anne edwards,REMARKABLE WOMAN,1990,9,2.5,4,1989,1
anne edwards,Royal Sisters: The Private Lives and Loves of Queen Elizabeth II and Princess Margaret,1991,10,0,1,1990,1
anne edwards,"The Road to Tara: The Life of Margaret Mitchell, Author of Gone With the Wind",1991,11,0,1,1991,0
anne edwards,The Grimaldis of Monaco,1992,12,4,2,1991,1
anne edwards,La Divina,1995,13,0,2,1992,3
anne edwards,Throne of Gold: The Lives of the Aga Khans,1996,14,4,1,1995,1
anne edwards,Streisand: A Biography,1997,15,0,2,1996,1
anne edwards,Streisand: A Biography,1998,16,7,1,1997,1
anne edwards,Ever After: Diana and the Life She Led,2000,17,0,1,1998,2
anne edwards,Ever After : Diana and the Life She Led,2001,18,10,1,2000,1
anne edwards,Maria Callas: An Intimate Biography,2001,19,0,2,2001,0
anne edwards,A Child's Bible (Piccolo Books),2001,20,0,1,2001,0
anne enright,The Wig My Father Wore,2001,2,0,1,2000,1
anne enright,What Are You Like?,2002,3,4,5,2001,1
anne finger,Bone Truth: A Novel,1994,2,8,1,1988,6
anne gay,Dancing on the Volcano,1993,2,2.6666666666666665,3,1991,2
anne gay,To Bathe in Lightning,1995,3,0,2,1993,2
anne graham lotz,The Vision of His Glory,1997,2,0,4,1997,0
anne graham lotz,God's Story,1999,3,0,2,1997,2
anne graham lotz,Just Give Me Jesus,2000,4,2,5,1999,1
anne graham lotz,Heaven: My Father's House,2001,5,8,1,2000,1
anne graham lotz,Why: Trusting God When You Don't Understand,2004,6,4,2,2001,3
anne heche,Call Me Crazy : A Memoir (Lisa Drew Books (Hardcover)),2001,2,3.1,20,2001,0
anne heche,Call Me Crazy : A Memoir (Lisa Drew Books (Hardcover)),2001,3,0,1,2001,0
anne heche,Call Me Crazy: A Memoir,2003,4,4.5,2,2001,2
anne kelleher bush,Children of Enchantment (Power &amp; the Pattern),1996,2,3.5,2,1995,1
anne kelleher bush,"Knight, the Harp, and the Maiden, The (Secrets of the Witch World)",1999,3,0,1,1996,3
anne knowles,An Ark on the Flood,1985,2,1.75,4,1983,2
anne lamott,Hard Laughter,1981,2,0,1,1980,1
anne lamott,Rosie,1985,3,4,3,1981,4
anne lamott,Joe Jones,1985,4,0,1,1985,0
anne lamott,Joe Jones,1987,5,0,1,1985,2
anne lamott,Hard Laughter: A Novel,1987,6,2.5294117647058822,17,1987,0
anne lamott,Rosie,1989,7,0,1,1987,2
anne lamott,All New People,1991,8,0,1,1989,2
anne lamott,Operating Instructions: A Journal of My Son's First Year,1993,9,0,3,1991,2
anne lamott,Bird by Bird: Some Instructions on Writing and Life,1994,10,3.2142857142857144,14,1993,1
anne lamott,Operating Instructions: A Journal of My Son's First Year,1994,11,4.410256410256411,39,1994,0
anne lamott,Bird by Bird: Some Instructions on Writing and Life,1995,12,4.785714285714286,42,1994,1
anne lamott,Crooked Little Heart,1997,13,3.6538461538461537,26,1995,2
anne lamott,Rosie: A Novel,1997,14,4.037037037037037,27,1997,0
anne lamott,Crooked Little Heart,1998,15,2.2083333333333335,24,1997,1
anne lamott,Traveling Mercies: Some Thoughts on Faith,1999,16,3.8260869565217392,46,1998,1
anne lamott,Traveling Mercies,1999,17,0,1,1999,0
anne lamott,All New People: A Novel,2000,18,2.6153846153846154,13,1999,1
anne lamott,Traveling Mercies: Some Thoughts on Faith,2000,19,4.122448979591836,49,2000,0
anne lamott,Blue Shoe,2002,20,4,2,2000,2
anne lamott,Blue Shoe,2002,21,2.9423076923076925,52,2002,0
anne lamott,Joe Jones: A Novel,2003,22,8,1,2002,1
anne lamott,Blue Shoe,2003,23,3.129032258064516,31,2003,0
anne logan,"Dial D For Destiny (Harlequin Superromance, No 585)",1994,2,5,1,1992,2
anne logan,"That Old Devil Moon (Women Who Dare) (Harlequin Superromance, No 688)",1996,3,1.6666666666666667,9,1994,2
anne logan,"Finding Kendall (Delta Justice, No 52)",1997,4,0,2,1996,1
anne m. fletcher,Thin for Life: 10 Keys to Success from People Who Have Lost Weight &amp; Kept It Off,1994,2,2,6,1994,0
anne m. fletcher,Thin for Life Daybook: A Journal of Personal Progress-Inspiration &amp; Keys to Success from People Who Have Lost Weight &amp; Kept It Off,1998,3,2.5,2,1994,4
anne m. fletcher,Eating Thin for Life: Food Secrets &amp; Recipes from People Who Have Lost Weight &amp; Kept It Off,1998,4,2,3,1998,0
anne marie forrest,Dancing Days,2001,2,0,1,2000,1
anne reed rooth,Southern Exposure,1999,2,5,2,1990,9
anne scott,"Serving Fire: Food for Thought, Body, and Soul",1994,2,0,1,1987,7
anne scott,Calpurnia,2003,3,0,1,1994,9
anne tyler,Searching for Caleb,1975,2,1.75,4,1974,1
anne tyler,Morgan's Passing,1980,3,0,1,1975,5
anne tyler,Dinner at the Homesick Restaurant,1982,4,1.8571428571428572,7,1980,2
anne tyler,Dinner Homesick Rest,1983,5,0,1,1982,1
anne tyler,Tin Can Tree,1983,6,1.5,4,1983,0
anne tyler,Celestial Navigation,1983,7,0,2,1983,0
anne tyler,Clock Winder,1983,8,0,2,1983,0
anne tyler,Earthly Possessions,1983,9,0,1,1983,0
anne tyler,If Morning Ever Comes,1983,10,0,1,1983,0
anne tyler,Slipping Down Life/A,1983,11,6.5,2,1983,0
anne tyler,Searching for Caleb,1983,12,2.8,5,1983,0
anne tyler,Dinner Homesick Rest,1983,13,1.3636363636363635,11,1983,0
anne tyler,If Morning Ever Comes,1983,14,4.714285714285714,7,1983,0
anne tyler,Dinner Home/Rest Can,1983,15,4,2,1983,0
anne tyler,Celestial Navigation,1984,16,3.2857142857142856,7,1983,1
anne tyler,Earthly Possessions,1984,17,0,1,1984,0
anne tyler,Dinner Homesick Rest,1985,18,2.7777777777777777,9,1984,1
anne tyler,A slipping-down life (G.K. Hall large print book series),1985,19,0,1,1985,0
anne tyler,Dinner Homesick Rest,1985,20,0,1,1985,0
anne tyler,The Accidental Tourist,1985,21,1.35,20,1985,0
anne tyler,Morgans Passing,1985,22,0,1,1985,0
anne tyler,Earthly Possessions,1986,23,0,1,1985,1
anne tyler,Accidental Tourist in,1986,24,0,2,1986,0
anne tyler,Morgans Passing,1986,25,2.466666666666667,15,1986,0
anne tyler,Breathing Lessons,1988,26,2.8666666666666667,30,1986,2
anne tyler,Accidental Tourist,1988,27,2.016949152542373,59,1988,0
anne tyler,Anne Tyler Four Complete Novels,1990,28,0,5,1988,2
anne tyler,Breathing Lessons,1990,29,0,1,1990,0
anne tyler,Caleb oder Das GlÃ?Â¼ck aus den Karten. Roman.,1991,30,0,1,1990,1
anne tyler,Saint Maybe,1991,31,1.903225806451613,31,1991,0
anne tyler,Saint Maybe,1991,32,0,3,1991,0
anne tyler,Anne Tyler: A New Collection/Three Complete Novels/the Accidental Tourist/Breathing Lessons/Searching for Caleb,1991,33,2.1,10,1991,0
anne tyler,AtemÃ?Â¼bungen. Roman.,1991,34,2.25,4,1991,0
anne tyler,The Tin Can Tree,1992,35,2.875,8,1991,1
anne tyler,Dinner at the Homesick Restaurant,1992,36,1.9142857142857144,35,1992,0
anne tyler,Morgan's Passing,1992,37,2.3333333333333335,9,1992,0
anne tyler,Dinner at the Homesick Restaurant,1992,38,2.590909090909091,22,1992,0
anne tyler,A Slipping-Down Life,1992,39,0.5,8,1992,0
anne tyler,Saint Maybe,1992,40,2.727272727272727,99,1992,0
anne tyler,The Clock Winder,1992,41,0,5,1992,0
anne tyler,A Slipping-Down Life,1992,42,1.6666666666666667,12,1992,0
anne tyler,The Clock Winder,1992,43,2.3333333333333335,3,1992,0
anne tyler,The Tin Can Tree,1992,44,0,4,1992,0
anne tyler,If Morning Ever Comes,1992,45,2.25,4,1992,0
anne tyler,Celestial Navigation,1993,46,3.090909090909091,22,1992,1
anne tyler,Celestial Navigation,1993,47,2.3846153846153846,13,1993,0
anne tyler,The Clock Winder,1993,48,6,1,1993,0
anne tyler,Searching for Caleb,1993,49,5.333333333333333,3,1993,0
anne tyler,Earthly Possessions,1993,50,1.3571428571428572,14,1993,0
anne tyler,Earthly Possessions,1993,51,3.6315789473684212,19,1993,0
anne tyler,Searching for Caleb,1993,52,0.6,10,1993,0
anne tyler,Breathing Lessons,1994,53,1.8705882352941177,170,1993,1
anne tyler,The Accidental Tourist,1994,54,2.074380165289256,121,1994,0
anne tyler,Breathing Lessons,1994,55,0,1,1994,0
anne tyler,Fast ein Heiliger.,1995,56,0,1,1994,1
anne tyler,Ladder of Years: A Novel,1995,57,0,1,1995,0
anne tyler,Ladder of Years,1995,58,2.9411764705882355,34,1995,0
anne tyler,Dinner at the Homesick Restaurant : A Novel,1996,59,2.1025641025641026,39,1995,1
anne tyler,Earthly Possessions,1996,60,3.8,10,1996,0
anne tyler,The Clock Winder (1st Ballantine Books Trade ed),1996,61,1.25,8,1996,0
anne tyler,Der BlechbÃ?Â¼chsenbaum.,1996,62,7,1,1996,0
anne tyler,Searching for Caleb,1996,63,2.5555555555555554,9,1996,0
anne tyler,Ladder of Years,1996,64,2.486111111111111,72,1996,0
anne tyler,The Tin Can Tree : A Novel (1st Ballantine Books Trade ed),1996,65,1.1666666666666667,6,1996,0
anne tyler,If Morning Ever Comes : A Novel,1996,66,4.166666666666667,12,1996,0
anne tyler,Celestial Navigation,1996,67,1.5,6,1996,0
anne tyler,Morgan's Passing,1996,68,4.125,8,1996,0
anne tyler,Saint Maybe,1996,69,4.1,10,1996,0
anne tyler,Ladder of Years,1997,70,2.2203389830508473,59,1996,1
anne tyler,A Slipping-Down Life,1997,71,2,3,1997,0
anne tyler,Breathing Lessons,1998,72,2.1052631578947367,19,1997,1
anne tyler,A Patchwork Planet,1998,73,3.1666666666666665,48,1998,0
anne tyler,The Accidental Tourist,1998,74,2.5714285714285716,7,1998,0
anne tyler,A Patchwork Planet (Random House Large Print),1998,75,0,2,1998,0
anne tyler,A Patchwork Planet (Ballantine Reader's Circle),1999,76,3.257575757575758,66,1998,1
anne tyler,Breathing Lessons,1999,77,1.75,4,1999,0
anne tyler,A Patchwork Planet,2001,78,2.6831683168316833,101,1999,2
anne tyler,Back When We Were Grownups,2001,79,0,1,2001,0
anne tyler,Anne Tyler: Three Complete Novels: A Patchwork Planet * Ladder of Years * Saint Maybe,2001,80,5.5,4,2001,0
anne tyler,Back When We Were Grownups (Random House Large Print),2001,81,4.25,4,2001,0
anne tyler,Back When We Were Grownups: A Novel,2001,82,3.4193548387096775,93,2001,0
anne tyler,The Accidental Tourist : A Novel (Ballantine Reader's Circle),2002,83,2.6,20,2001,1
anne tyler,Back When We Were Grownups : A Novel (Ballantine Reader's Circle),2002,84,3.6946564885496183,131,2002,0
anne tyler,The Amateur Marriage,2004,85,0,2,2002,2
anne tyler,A Slipping-Down Life,2004,86,0,3,2004,0
anne tyler,The Amateur Marriage: A Novel,2004,87,2.484848484848485,33,2004,0
anne ursu,The Disapparation of James,2003,2,5.285714285714286,7,2002,1
anne ursu,Spilling Clarence : A Novel,2003,3,2,10,2003,0
anne van wagner childs,Creative Christmas Kitchen/21421 (Memories in the Making Series),1992,2,6,1,1991,1
anne van wagner childs,Creative Touches: Memories in the Making Series (Memories in the Making),1992,3,8,2,1992,0
anne van wagner childs,Merry Christmas ABC (Christmas Remembered ; Bk. 6),1993,4,5,1,1992,1
anne van wagner childs,Down Santa Claus Lane (Christmas Remembered ; Bk. 8),1994,5,0,1,1993,1
anne van wagner childs,Sew No More: Home Decor (Memories in the Making Series),1994,6,4.5,2,1994,0
anne van wagner childs,In the Nick of Time (Memories in the Making Series),1994,7,0,1,1994,0
anne van wagner childs,"Seasons Remembered (Leisure Arts Presents Christmas Remembered, Bk. 9)",1995,8,9,1,1994,1
anne van wagner childs,Angels Remembered,1996,9,0,1,1995,1
anne van wagner childs,Christmas Gifts Under $10 (Clever Crafter Series),1997,10,3.5,2,1996,1
anne van wagner childs,Trash to Treasure: The Recycler's Guide to Creative Crafts (Memories in the Making Series),1997,11,4.75,4,1997,0
anne van wagner childs,In Love With Crochet (Crochet Collection Series),1997,12,0,2,1997,0
anne van wagner childs,Trash to Treasure: The Year's Best Creative Crafts (Trash to Treasure),1998,13,7.5,2,1997,1
anne van wagner childs,Holiday Crafts Under $10 (Clever Crafter Series),1998,14,9,1,1998,0
anne van wagner childs,Handmade Gifts Under $10 (Clever Crafter Series),1998,15,8,1,1998,0
anne west,Warum MÃ?Â¤nner so schnell kommen und Frauen nur so tun als ob. Eine Gebrauchsanweisung fÃ?Â¼r das andere Geschlecht.,2003,2,5.333333333333333,3,2003,0
anne willan,Look &amp; Cook: Splendid Soups,1994,2,0,1,1992,2
anne willan,Look &amp; Cook: Creative Casseroles,1994,3,0,1,1994,0
anne willan,Chateau Cuisine,1995,4,4,1,1994,1
anne willan,101 Essential Tips: Chicken,1996,5,8,1,1995,1
anne willan,French Recipes,1996,6,0,1,1996,0
anne willan,Anne Willan's Cook It Right: Achieve Perfection With Every Dish You Cook,1998,7,8,1,1996,2
annemarie rosier,Toshiba Book of Microwave Cookery,1996,2,5,1,1986,10
annette broadrick,"Hawk'S Flight (Silhouette Desire, No. 242)",1985,2,0,1,1984,1
annette broadrick,Bachelor Father,1985,3,0,1,1985,0
annette broadrick,Unheavenly Angel (Silhouette Romances),1986,4,0,1,1985,1
annette broadrick,"Heat Of The Night (Silhouette Desire, No. 314)",1986,5,0,2,1986,0
annette broadrick,"Made In Heaven (Silhouette Desire, No. 336)",1987,6,0,1,1986,1
annette broadrick,"Adam'S Story (Silhouette Desire, No 367)",1987,7,0,1,1987,0
annette broadrick,Return to Yesterday (Western Lovers Reunited Hearts),1987,8,0,1,1987,0
annette broadrick,"With All My Heart : Thirteen Stories About Growing Up Jewish (Silhouette Desire, No 433)",1988,9,0,1,1987,1
annette broadrick,"Love Remembered (Silhouette Romance, No 676)",1989,10,0,1,1988,1
annette broadrick,"Loving Spirit (Desire, 552)",1990,11,0,1,1989,1
annette broadrick,"Lone Wolf (Harlequin Desire, No 666)",1991,12,0,4,1990,1
annette broadrick,"Marriage Texas Style! (Silhouette Desire, No 745)",1992,13,0,2,1991,1
annette broadrick,"Love Texas Style (Silhouette Desire, No 5734)",1992,14,0,3,1992,0
annette broadrick,"Courtship Texas Style (Silhouette Desire, 739)",1992,15,0,2,1992,0
annette broadrick,"Deceptions (Men Made In America Series) #5 (Men Made in America, No 5)",1993,16,0,2,1992,1
annette broadrick,Silhouette Spring Fancy (3 Stories in 1 Vol.),1993,17,0,6,1993,0
annette broadrick,Solution:  Marriage (By Request Series) Volume 6 (By Request),1993,18,0,1,1993,0
annette broadrick,"Mystery Wife (That Special Woman) (Silhouette Special Edition, No 877)",1994,19,1.1666666666666667,6,1993,1
annette broadrick,"Temptation Texas Style! (Man Of The Month, Sons Of Texas) (Silhouette Desire, No 883)",1994,20,0,4,1994,0
annette broadrick,"Impromptu Bride (Celebration 100!) (Silhouette Romance, No 1018)",1994,21,0,1,1994,0
annette broadrick,"Mysterious Mountain Man (Man Of The Month) (Silhouette Desire, No 925)",1995,22,0,2,1994,1
annette broadrick,Return To Yesterday  (Western Lovers #14),1995,23,0,1,1995,0
annette broadrick,"Help Wanted - Angel: A Loving Spirit, Earth Angel, Angel for Hire",1995,24,2.5,6,1995,0
annette broadrick,Married?! (Make Believe Matrimony) (Here Come the Grooms),1996,25,0,1,1995,1
annette broadrick,"Instant Mommy (Bundles Of Joy, Daughters Of Texas) (Silhouette Romance No 1139)",1996,26,0,1,1996,0
annette broadrick,Sons Of Texas: Rogues And Ranchers (Harlequin by Request: Sons of Texas),1996,27,0,7,1996,0
annette broadrick,"Megan'S Marriage (Silhouette Desire, No 979)",1996,28,0,1,1996,0
annette broadrick,Wanted: Mother,1996,29,8,1,1996,0
annette broadrick,"Groom, I Presume? (Daughters Of Texas) (Silhouette Desire, No 992)",1996,30,8,1,1996,0
annette broadrick,Irresistible (And the Winner Is),1997,31,0,5,1996,1
annette broadrick,Sons Of Texas: Love And Courtship (By Request) (By Request),1998,32,0,3,1997,1
annette broadrick,"Unforgettable Bride (Virgin Brides) (Silhouette Romance , No 1294)",1998,33,1,7,1998,0
annette broadrick,Unheavenly Angel,1999,34,3,2,1998,1
annette broadrick,"Lean Mean &amp; Lonesome  (Man Of The Month/Man Of The Month Anniversary) (Silhouette Desire, 1237)",1999,35,3.4,5,1999,0
annette broadrick,Sons Of Texas:  Cowboys And Wedding Bells  (By Request) (By Request),1999,36,2,5,1999,0
annette broadrick,"Tall, Dark &amp; Texan (Man Of The Month/50th Book) (Silhouette Desire, 1261)",1999,37,0.6666666666666666,3,1999,0
annette broadrick,"President'S Daughter (Silhouette Special Edition, 1226)",1999,38,0,1,1999,0
annette broadrick,Sons of Texas : Callaway Country,2000,39,2.5,8,1999,1
annette broadrick,Maximum Marriage: Men On A Mission (Silhouette Promo),2000,40,6.5,2,2000,0
annette broadrick,Daughters Of Texas (By Request 3'S) (By Request 3's),2000,41,2.4,5,2000,0
annette broadrick,"Marriage Prey (20th Anniversary Title) (Desire, 1327)",2000,42,2.6666666666666665,3,2000,0
annette broadrick,Love Child (By Request 2'S) (By Request 2's),2000,43,1.6,5,2000,0
annette broadrick,"Hard To Forget (Man Of The Month) (Desire, 1381)",2001,44,2.6,5,2000,1
annette broadrick,"But Not For Me (Silhouette Special Edition, No. 1472)",2002,45,1.3636363636363635,11,2001,1
annette broadrick,Secret Agent Grooms (By Request 3's): Adam's Story/The Gemini Man/Zeke,2002,46,0,8,2002,0
annette broadrick,Western Rogues (By Request 2'S) (By Request 2's),2002,47,2.3333333333333335,3,2002,0
annette broadrick,"Too Tough To Tame   Secret Sisters (Silhouette Special Edition, 1581)",2003,48,0,4,2002,1
annette broadrick,"Man In The Mist   Secret Sisters (Silhouette Special Edition, 1576)",2003,49,0,4,2003,0
annette broadrick,"MacGowan Meets His Match (Silhouette Special Edition, 1586)",2004,50,0,5,2003,1
annette dã?â¶brich,Am Abgrund der TrÃ?Â¤ume.,2001,2,8,1,1999,2
annette kuhn,The Women's Companion to International Film,1994,2,0,1,1990,4
annette motley,"Green Dragon, White Tiger",1988,2,4,2,1986,2
annie jones,"The Double Heart Diner (Jones, Annie, Route 66 Series, Bk. 1.)",1999,2,4.5,2,1998,1
annie jones,Cupid's Corner (Book Two in the Route 66 romantic comedy series),1999,3,2,4,1999,0
annie jones,Deep Dixie (Alabaster Books),1999,4,5,1,1999,0
annie jones,Lost Romance Ranch (Route 66 Romantic Comedy Series),2000,5,2.6666666666666665,3,1999,1
annie jones,The Snowbirds,2001,6,0,1,2000,1
annie mcknight,The Tombstone Rose,2000,2,0,1,1998,2
annie wang,Lili,2002,2,3,3,2001,1
anon,Night in a Moorish Harem,1999,2,2.5,2,1999,0
anon,Memoirs of a Voluptuary,1999,3,0,1,1999,0
anthony alessandra,Charisma : Seven Keys to Developing the Magnetism That Leads to Success,1998,2,0,1,1996,2
anthony bailey,A Walk Through Wales,1993,2,0,1,1992,1
anthony bailey,The Coast of Summer: Sailing New England Waters from Shelter Island to Cape Cod,1999,3,0,2,1993,6
anthony bailey,Vermeer: A View of Delft,2001,4,0,2,1999,2
anthony bailey,Vermeer: A View of Delft,2002,5,0,1,2001,1
anthony beevor,Stalingrado,2000,2,4,2,1999,1
anthony bourdain,Kitchen Confidential : Adventures in the Culinary Underbelly,2000,2,4.535714285714286,28,1997,3
anthony bourdain,Bone in the Throat,2000,3,4,11,2000,0
anthony bourdain,Kitchen Confidential,2000,4,0,1,2000,0
anthony bourdain,Gone Bamboo,2000,5,4.25,4,2000,0
anthony bourdain,A Cook's Tour,2001,6,3.3333333333333335,21,2000,1
anthony bourdain,Kitchen Confidential: Adventures in the Culinary Underbelly (Thorndike Nonfiction),2001,7,0,1,2001,0
anthony bourdain,Typhoid Mary: An Urban Historical,2001,8,3.25,12,2001,0
anthony bourdain,Kitchen Confidential: Adventures in the Culinary Underbelly,2001,9,4.280701754385965,57,2001,0
anthony bourdain,Confesiones de Un Chef - Aventuras En Transfondo,2001,10,5,1,2001,0
anthony bourdain,Kitchen Confidential : Adventures in the Culinary Underbelly,2001,11,8,1,2001,0
anthony bourdain,A Cook's Tour : Global Adventures in Extreme Cuisines,2002,12,4.413793103448276,29,2001,1
anthony bourdain,A Cook's Tour,2002,13,7,1,2002,0
anthony bourdain,GestÃ?Â¤ndnisse eines KÃ?Â¼chenchefs. Was Sie Ã?Â¼ber Restaurants nie wissen wollten.,2003,14,3.6666666666666665,3,2002,1
anthony bourdain,"The Bobby Gold Stories : A Novel (Bourdain, Anthony. Bobby Gold.)",2003,15,0,1,2003,0
anthony bourdain,The Bobby Gold Stories : A Novel,2004,16,4,1,2003,1
anthony burgess,"The Clockwork Testament; Or, Enderby's End",1975,2,0,1,1973,2
anthony burgess,Nothing Like the Sun: A Story of Shakespeare's Love-Life (The Norton Library),1975,3,0,1,1975,0
anthony burgess,The Doctor Is Sick,1979,4,1.6666666666666667,3,1975,4
anthony burgess,Earthly powers,1980,5,7,1,1979,1
anthony burgess,Earthly Powers,1981,6,0,6,1980,1
anthony burgess,Enderby,1982,7,0,1,1981,1
anthony burgess,Clockwork Orange,1983,8,0,5,1982,1
anthony burgess,The End of the World News: An Entertainment,1983,9,0,1,1983,0
anthony burgess,99 Novels: The Best in English Since 1939,1984,10,0,1,1983,1
anthony burgess,Enderby's Dark Lady or No End to Enderby/300571,1984,11,0,1,1984,0
anthony burgess,The End of the World News,1984,12,3.5714285714285716,7,1984,0
anthony burgess,The Kingdom of the Wicked,1985,13,0,3,1984,1
anthony burgess,A Clockwork Orange (Norton Paperback Fiction),1986,14,5.019230769230769,52,1985,1
anthony burgess,Las Mujeres Romanas De Beard/Beard's Roman Women,1986,15,0,1,1986,0
anthony burgess,Clockwork Orange,1986,16,0,2,1986,0
anthony burgess,The Pianoplayers,1986,17,0,3,1986,0
anthony burgess,The Kingdom of the Wicked,1986,18,0,2,1986,0
anthony burgess,Clockwork Orange,1987,19,9,2,1986,1
anthony burgess,The Pianoplayers: Anthony Burgess,1987,20,5,1,1987,0
anthony burgess,Clockwork Orange,1988,21,2.6,10,1987,1
anthony burgess,Any Old Iron,1989,22,1.6666666666666667,3,1988,1
anthony burgess,A Clockwork Orange. ( Fremdsprachentexte). (Lernmaterialien),1992,23,0,3,1989,3
anthony burgess,"A Mouthful of Air: Language, Languages...Especially English",1993,24,0,1,1992,1
anthony burgess,The Long Day Wanes: A Malayan Trilogy (The Norton Library),1993,25,0,1,1993,0
anthony burgess,A Clockwork Orange,1994,26,0,1,1993,1
anthony burgess,Earthly Powers,1994,27,10,1,1994,0
anthony burgess,A Dead Man in Deptford,1995,28,0,1,1994,1
anthony burgess,El Reino de Los Reprobos,1996,29,6,1,1995,1
anthony burgess,The Wanting Seed (Norton Paperback Fiction),1996,30,6.75,4,1996,0
anthony burgess,Honey for the Bears (Norton Paperback Fiction),1996,31,0,2,1996,0
anthony burgess,A Clockwork Orange,1997,32,0,1,1996,1
anthony burgess,The Doctor Is Sick,1997,33,0,1,1997,0
anthony burgess,Arancia Meccanica,1998,34,5.333333333333333,3,1997,1
anthony burgess,"Naranja Mecanica, La",1999,35,8.2,5,1998,1
anthony burgess,A Clockwork Orange,2000,36,0,1,1999,1
anthony burgess,Re Joyce,2000,37,0,1,2000,0
anthony burgess,Shakespeare,2002,38,0,1,2000,2
anthony burgess,LA Naranja Mecanica,2003,39,5.666666666666667,3,2002,1
anthony chandor,The Penguin Dictionary of Microprocessors (Penguin Reference Books),1981,2,0.5,2,1970,11
anthony chandor,The Penguin Dictionary of Computers (Reference Books),1985,3,0,1,1981,4
anthony curtis,"The Lyle Official Antiques Review, 1993 (Lyle Official Antiques Review)",1992,2,0,1,1991,1
anthony curtis,Bargain City,1993,3,0,1,1992,1
anthony curtis,Lyle: Cashing in on Collecting Americana,1993,4,0,1,1993,0
anthony curtis,"The Lyle Official Antiques Review, 1997 (Serial)",1996,5,0,1,1993,3
anthony curtis,"Lyle Official Antiques Review 2000 (Lyle Official Antiques Review, 2000)",1999,6,0,2,1996,3
anthony curtis,"Lyle Official Antiques Review 2001 (Lyle Official Antiques Review, 2001)",2000,7,9,1,1999,1
anthony dias blue,America's Kitchen: Traditional &amp; Contemporary Regional Cooking : Featuring Recipes from America's Most Celebrated Chefs,1995,2,0,1,1993,2
anthony horowitz,The Falcon's Malteser: Starring the Famous Diamond Brothers,1991,2,0,1,1986,5
anthony horowitz,Myths and Legends (Story Library (Paperback)),1994,3,4.5,2,1991,3
anthony horowitz,Death Walks Tonight: Horrifying Stories,1996,4,6.666666666666667,3,1994,2
anthony horowitz,Public Enemy Number Two (The Diamond Brothers Trilogy),1997,5,0,1,1996,1
anthony horowitz,Point Blanc,2001,6,2.5,2,1997,4
anthony horowitz,Stormbreaker (Alex Rider Adventure),2001,7,5.666666666666667,3,2001,0
anthony horowitz,Stormbreaker,2002,8,3.75,4,2001,1
anthony horowitz,Stormbreaker (Alex Rider Adventure),2002,9,4,4,2002,0
anthony horowitz,Point Blank,2002,10,8,1,2002,0
anthony horowitz,Point Blank (Alex Rider Adventure),2002,11,2.6666666666666665,3,2002,0
anthony horowitz,Skeleton Key,2002,12,3.5,2,2002,0
anthony horowitz,Point Blank (Alex Rider Adventure),2003,13,0,2,2002,1
anthony horowitz,Skeleton Key (Alex Rider Adventure),2003,14,0,2,2003,0
anthony horowitz,Stormbreaker,2004,15,4,1,2003,1
anthony horowitz,STORMBREAKER (Alex Rider Adventure),2004,16,0,1,2004,0
anthony horowitz,Eagle Strike (Alex Rider Adventure),2004,17,0,1,2004,0
anthony lake,6 Nightmares : The Real Threats to American Security...,2001,2,3.5,2,2000,1
anthony pagden,"Peoples and Empires: A Short History of European Migration, Exploration, and Conquest, from Greece to the Present (Modern Library Chronciles)",2003,2,5,1,2001,2
anthony parinello,Selling To VITO (The Very Important Top Officer),1999,2,9,1,1994,5
anthony powell,Military Philosophers (A Dance to the Music of Time),1985,2,0,1,1985,0
anthony powell,A Question of Upbringing,1985,3,0,1,1985,0
anthony powell,A Dance to the Music of Time: Fourth Movement (Dance to the Music of Time),1995,4,10,1,1985,10
anthony powell,A Dance to the Music of Time: First Movement (Dance to the Music of Time),1995,5,5.5,4,1995,0
anthony powell,A Dance to the Music of Time: Third Movement (Dance to the Music of Time),1995,6,10,1,1995,0
anthony powell,A Dance to the Music of Time: Second Movement (Dance to the Music of Time),1995,7,10,1,1995,0
anthony powell,A Dance To The Music Of Time:  Vol. 1 - (From The 1st Movement),1996,8,0,1,1995,1
anthony powell,Venusburg,1999,9,7,1,1996,3
anthony powell,To Keep the Ball Rolling: The Memoirs of Anthony Powell,2001,10,9,1,1999,2
anthony powell,"O, How the Wheel Becomes It! (Green Integer, 114)",2002,11,2.5,2,2001,1
anthony quinn,One Man Tango,1995,2,0,1,1972,23
antonia barber,GHOSTS : GHOSTS,1989,2,3.5,2,1984,5
antonia barber,Gemma and the Baby Chick,1993,3,0,1,1989,4
antonia barber,Catkin,1996,4,5.176470588235294,17,1993,3
antonia barber,The Mousehole Cat,1996,5,0,1,1996,0
antonia barber,Die schÃ?Â¶nste aller Blumen. Vergessene MÃ?Â¤rchen aus Europas Osten. ( Ab 5 J.).,2002,6,10,1,1996,6
antonio gala,Mas Alla Del Jardin (ColecciÃ³n Autores espaÃ±oles e hispanoamericanos),1995,2,0,1,1994,1
antonio gala,El Manuscrito Carmesi (Coleccion Autores Espa~noles E Hispanoamericanos),1995,3,0,1,1995,0
antonio gala,LA Pasion Turca,1995,4,3.5714285714285716,7,1995,0
antonio gala,El Manuscrito Carmesi,1996,5,0,1,1995,1
antonio gala,Die Handschrift von Granada. Historischer Roman.,1996,6,0,2,1996,0
antonio gala,Carta a Los Herederos (Documento),1997,7,6,2,1996,1
antonio gala,Mas Alla Del Jardin - Further from the Garden,1997,8,0,1,1997,0
antonio gala,A Quien Conmigo Va,1998,9,4,2,1997,1
antonio gala,LA Pasion Turca,1998,10,2.3333333333333335,3,1998,0
antonio gala,Poemas de Amor / Love Poems,1998,11,0,3,1998,0
antonio gala,El Canter De Los Cantares,1998,12,9,1,1998,0
antonio gala,El Manuscrito Carmesi,1998,13,0,2,1998,0
antonio gala,"Afueras de Dios, Las",1999,14,5,1,1998,1
antonio gala,Ahora Hablare de Mi,2000,15,0,3,1999,1
antonio gala,La Passion turque,2000,16,0,2,2000,0
antonio gala,El Imposible Olvido,2001,17,3.5,2,2000,1
antonio gala,Los Invitados Al Jardin (Autores Espa~noles E Iberoamericanos),2002,18,1.6666666666666667,3,2001,1
antonio gala,Mas Alla Del Jardin,2003,19,0,1,2002,1
antonio gala,El Dueno De LA Herida,2003,20,3.5,2,2003,0
antonio gala,LA Regla De Tres,2003,21,9,1,2003,0
antonio gala,El Manuscrito Carmes,2003,22,0,1,2003,0
antonio lobo antunes,Act of the Damned,1996,2,0.25,4,1995,1
antonio lobo antunes,Reigen der Verdammten.,1997,3,3.3333333333333335,3,1996,1
antonio lobo antunes,Der Tod des Carlos Gardel.,2000,4,0,1,1997,3
antonio lobo antunes,En El Culo del Mundo,2001,5,0,1,2000,1
antonio lobo antunes,N'entre pas si vite dans cette nuit noire,2001,6,4.5,2,2001,0
antonio lobo antunes,Anweisungen an die Krokodile.,2001,7,3,1,2001,0
antonio lobo antunes,The Inquisitors' Manual,2002,8,0,1,2001,1
antonio lobo antunes,The Return of the Caravels,2003,9,0,1,2002,1
antonio lobo antunes,No Entres Tan Deprisa En ESA Noche Oscura,2003,10,0,1,2003,0
antonio lobo antunes,El Orden Natural de Las Cosas,2004,11,8,2,2003,1
antonio lobo antunes,The Inquisitors' Manual,2004,12,0,1,2004,0
antonio lobo antunes,Auto de Los Condenados,2004,13,7,1,2004,0
antonio machado,Campos de Castilla,1989,2,0,2,1975,14
antonio machado,Soledades.Galerias.Otros Poemas,1990,3,8,2,1989,1
antonio machado,Poesia,1992,4,7,1,1990,2
antonio machado,Antologia Poetica,1996,5,10,1,1992,4
antonio machado,Poesias completas,1997,6,7.75,4,1996,1
antonio machado,Poesia (Seccion Clasicos),1997,7,9,1,1997,0
antonio machado,Machado: Campos de Castilla,1997,8,0,1,1997,0
antonio machado,Border of a Dream : Selected Poems of Antonio Machado,2003,9,8,1,1997,6
antonio machado,There is No Road : Proverbs by Antonio Machado (Companions for the Journey),2003,10,4.5,4,2003,0
antony miall,The Xenophobe's Guide to the English,1999,2,0,1,1996,3
antã³nio lobo antunes,O manual dos inquisidores (Obras de AntÃ³nio Lobo Antunes),1996,2,8,1,1994,2
anwer bati,The Essential Cigar: A Book for Connoisseurs,1997,2,5,1,1995,2
apirana taylor,He tangi aroha,1993,2,0,2,1991,2
apple jordan,How to Draw Strawberry Shortcake (Strawberry Shortcake),2004,2,0,1,2002,2
archibald d. hart,Adrenalin and Stress,1991,2,0,1,1984,7
archibald d. hart,Secrets Of Eve,1998,3,0,2,1991,7
archibald macleish,J.B. : A Play in Verse,1989,2,3.75,4,1985,4
ardal o'hanlon,The Talk of the Town,1999,2,4,6,1999,0
ardal o'hanlon,Talk of the Town.,2000,3,0,2,1999,1
ardal o'hanlon,Knick Knack Paddy Whack,2000,4,0,2,2000,0
ardal o'hanlon,Talk of the Town.,2001,5,5,1,2000,1
ardath mayhar,Soul-Singer of Tyrnos,1981,2,0,1,1980,1
ardath mayhar,Golden Dream: A Fuzzy Odyssey,1982,3,0,1,1981,1
ardath mayhar,Khi to Freedom,1983,4,0,1,1982,1
ardath mayhar,Lords of the Triple Moons,1984,5,0,1,1983,1
ardath mayhar,Monkey Station,1989,6,7,1,1984,5
ardath mayhar,People of the Mesa,1992,7,8,1,1989,3
ariel jennifer jones,MADEMOISELLE,1989,2,5,1,1987,2
ariel jennifer jones,HACKSAW,1990,3,0,1,1989,1
ariel jennifer jones,ALL SHE WANTED,1996,4,1,4,1990,6
arlene dubanevich,Pig William,1985,2,0,1,1983,2
arlene dubanevich,Pigs in Hiding,1988,3,5,1,1985,3
arlene dubanevich,Pigs in Hiding,1989,4,7,1,1988,1
arlene dubanevich,Pig William (Reading Rainbow),1990,5,0,1,1989,1
arlene dubanevich,Tom's Tail (Picture Puffins),1992,6,0,1,1990,2
arlene mosel,Tikki Tikki Tembo,1986,2,0,2,1983,3
arlene mosel,Tikki Tikki Tembo (An Owlet Book),1989,3,6,1,1986,3
arlene tognetti,The Complete Idiot's Guide to Tarot (Complete Idiot's Guide to...),2003,2,0,1,1998,5
arlie russell hochschild,The Time Bind: When Work Becomes Home and Home Becomes Work,2001,2,2.5,2,1997,4
arnold kellett,"Ee by Gum, Lord!: The Gospels in Broad Yorkshire",1996,2,8,1,1991,5
aron appelfeld,The immortal Bartfuss,1989,2,5,1,1986,3
art bell,"The Quickening: Today's Trends, Tomorrow's World",1997,2,5,1,1996,1
art bell,The Art of Talk,1998,3,9,1,1997,1
art bell,The Coming Global Superstorm,1999,4,5.2,5,1998,1
art bell,The Coming Global Superstorm,2000,5,3.25,4,1999,1
art bell,The Source: Journey Through the Unexplained,2002,6,3.3333333333333335,3,2000,2
art crockett,Celebrity Murders,1990,2,5.666666666666667,3,1990,0
art linkletter,Old Age Is Not for Sissies: Choices for Senior Americans,1988,2,0,1,1978,10
art linkletter,Old Age Is Not for Sissies: Choices for Senior Americans,1989,3,0,1,1988,1
arthur aron,Statistics for the Behavioral and Social Sciences: A Brief Course,1996,2,6,1,1984,12
arthur bloch,Murphy's Law Book Three: Wrong Reasons Why Things Go More,1982,2,0,3,1980,2
arthur bloch,Comp Murphy's Law,1990,3,4.5,2,1982,8
arthur bloch,The Complete Murphy's Law: A Definitive Collection,1991,4,5,1,1990,1
arthur bloch,Murphy's Law: Doctors : Malpractice Makes Perfect,2000,5,0,1,1991,9
arthur bloch,Murphy's Law: Lawyers : Wronging the Rights in the Legal Profession!,2000,6,7,1,2000,0
arthur bloch,Healing Yourself With Wishful Thinking,2002,7,4,2,2000,2
arthur bloch,Murphy's Law,2003,8,1.5,4,2002,1
arthur byron cover,Los Anillos De Saturno/the Rings of Saturn: LA Maquina Del Tiempo 6/Time Machine 6,1985,2,7,1,1985,0
arthur byron cover,American Revolutionary (Time Machine No 10),1987,3,0,1,1985,2
arthur byron cover,"Planetfall (Infocom, No 1)",1988,4,2,2,1987,1
arthur byron cover,"Night of the Living Rerun (Buffy the Vampire Slayer, Book 4)",1998,5,1.0588235294117647,17,1988,10
arthur byron cover,"J. Michael Straczynski's Rising Stars, Book 2: Ten Years After",2002,6,1.6666666666666667,3,1998,4
arthur frommer,The Unofficial Guide to Disneyland 1999 (Serial),1998,2,3.3333333333333335,3,1991,7
arthur frommer,Frommer's Mexico 2000,1999,3,0,2,1998,1
arthur frommer,Frommer's 2000 Walt Disney World &amp; Orlando (Frommer's Walt Disney World and Orlando 2000),1999,4,3.5,2,1999,0
arthur frommer,Frommer's Europe from $60 a Day 2000,1999,5,0,1,1999,0
arthur frommer,"Frommer's 2000 Bahamas (Frommer's Bahamas, 2000)",1999,6,7,1,1999,0
arthur frommer,Frommer's Costa Rica 2000,1999,7,8,1,1999,0
arthur frommer,"Frommer's 2001 Walt Disney World &amp; Orlando (Frommer's Walt Disney World and Orlando, 2001)",2000,8,5,1,1999,1
arthur gold,The Divine Sarah: A Life of Sarah Bernhardt,1992,2,8,1,1980,12
arthur h. landis,Home--To Avalon,1982,2,0,1,1982,0
arthur herzog,Swarm,1978,2,0,1,1976,2
arthur herzog,"Vesco: From Wall Street to Castro's Cuba the Rise, Fall, and Exile of the King of White Collar Crime",1987,3,0,1,1978,9
arthur herzog,Heat,1989,4,0,1,1987,2
arthur herzog,The Woodchipper Murder,1990,5,1.3,10,1989,1
arthur herzog,Earthsound,2003,6,0,1,1990,13
arthur mather,The Los Alamos Contract,1988,2,0,1,1986,2
arthur ransome,Winter Holiday (Godine Storyteller),1989,2,0,2,1986,3
arthur ransome,Pigeon Post,1992,3,0,2,1989,3
arthur ransome,Favorite Russian Fairy Tales (Dover Children's Thrift Classics),1995,4,1.1666666666666667,6,1992,3
arthur schnitzler,Casanovas Heimfahr,1992,2,0,1,1992,0
arthur schnitzler,Hands Around: A Cycle of Ten Dialogues (Dover Thrift Editions),1995,3,0,3,1992,3
arthur schnitzler,"Dream Story (Sun and Moon Classics, 6)",1995,4,0,2,1995,0
arthur schnitzler,Eyes Wide Shut,1999,5,8.5,2,1995,4
arthur schnitzler,Eyes Wide Shut,1999,6,0,1,1999,0
arthur schnitzler,Relato soÃ±ado,2000,7,8,1,1999,1
arthur schnitzler,Jugend in Wien.,2000,8,0,2,2000,0
arthur schnitzler,Anatol. Dramen 1888 - 1891.,2000,9,5,1,2000,0
arthur schnitzler,Dream Story (Green Integer),2003,10,0,2,2000,3
arto paasilinna,Suloinen myrkynkeittÃ¤jÃ¤: Romaani,1988,2,0,1,1987,1
arto paasilinna,Hurmaava joukkoitsemurha: Romaani,1990,3,7,1,1988,2
arto paasilinna,Le LiÃ?Â¨vre de Vatanen,1993,4,5.75,4,1990,3
arto paasilinna,Le Fils du Dieu de l'orage,1995,5,7.5,2,1993,2
arto paasilinna,Prisonniers du paradis,1998,6,2.8,5,1995,3
arto paasilinna,Das Jahr des Hasen.,1999,7,1.5,4,1998,1
arto paasilinna,La Cavale du gÃ?Â©omÃ?Â¨tre,2000,8,6,4,1999,1
arto paasilinna,Die GiftkÃ?Â¶chin.,2000,9,7.666666666666667,3,2000,0
arto paasilinna,Im Wald der gehenkten FÃ?Â¼chse.,2001,10,2.888888888888889,9,2000,1
arto paasilinna,Der Sohn des Donnergottes.,2001,11,4.5,2,2001,0
arto paasilinna,Der Sommer der lachenden KÃ?Â¼he.,2001,12,1.6,5,2001,0
arto paasilinna,La Douce Empoisonneuse,2001,13,0,1,2001,0
arto paasilinna,Die Rache des glÃ?Â¼cklichen Mannes.,2002,14,4,2,2001,1
arto paasilinna,Das Jahr des Hasen.,2003,15,4.5,2,2002,1
arto paasilinna,La Douce empoisonneuse,2003,16,4.625,8,2003,0
arto paasilinna,Der Sommer der lachenden KÃ?Â¼he.,2003,17,3.4,5,2003,0
atima srivastava,Looking for Maya,1999,2,4,1,1993,6
audean johnson,A to Z: Look and See (Picturebacks),1989,2,0,1,1982,7
audrey peterson,MURDER IN BURGUNDY,1989,2,0,1,1988,1
audrey peterson,DEATH IN WESSEX,1989,3,0,1,1989,0
audrey peterson,ELEGY IN A COUNTRY GRAVEYARD : ELEGY IN A COUNTRY GRAVEYARD,1990,4,0,1,1989,1
audrey peterson,DEADLY REHEARSAL,1990,5,0,1,1990,0
audrey peterson,LAMENT FOR CHRISTABEL,1991,6,0,1,1990,1
audrey peterson,DARTMOOR BURIAL : DARTMOOR BURIAL,1992,7,0,2,1991,1
audrey peterson,DEATH TOO SOON : DEATH TOO SOON,1994,8,0,1,1992,2
august strindberg,Strindberg: Five Plays,1983,2,6,1,1955,28
august strindberg,Plays from the Cynical Life (The Washington Strindberg),1983,3,10,1,1983,0
august strindberg,By the Open Sea (Penguin Classics),1987,4,0,1,1983,4
august strindberg,Miss Julie (Dover Thrift Editions),1992,5,2.3333333333333335,6,1987,5
august strindberg,Miss Julie and Other Plays (Oxford World's Classics),1999,6,6,2,1992,7
august strindberg,Le Fils de la servante,2001,7,0,2,1999,2
august wilson,The Piano Lesson (Plume Drama),1990,2,3.888888888888889,9,1988,2
august wilson,Joe Turner's Come and Gone: A Play in Two Acts,1992,3,4,3,1990,2
august wilson,Two Trains Running (Plume Drama),1993,4,4,2,1992,1
august wilson,Fences,1995,5,3.142857142857143,7,1993,2
auguste rodin,Auguste Rodin (Postcardbooks),1999,2,9,1,1984,15
avery corman,The Old Neighborhood: A Novel,1980,2,2.5,2,1977,3
avery corman,The Old Neighborhood,1981,3,1.6666666666666667,6,1980,1
avery corman,Kramer Vs. Kramer,1981,4,3.5,4,1981,0
avery corman,Fifty,1987,5,0,1,1981,6
avery corman,50 (G.K. Hall Large Print Book Series),1988,6,0,1,1987,1
avery corman,50,1988,7,8,1,1988,0
avery corman,Kramer Versus Kramer,1988,8,0,1,1988,0
avery corman,Prized Possessions,1991,9,0,1,1988,3
avery corman,BIG HYPE,1992,10,0,3,1991,1
avery corman,Prized Possessions,1992,11,0,1,1992,0
axel madsen,The Sewing Circle: Hollywood's Greatest Secret : Female Stars Who Loved Other Women,1995,2,0.7142857142857143,14,1987,8
axel madsen,The Sewing Circle: Sappho's Leading Ladies,2002,3,0,3,1995,7
b. joseph pine,The Experience Economy,1999,2,5,1,1999,0
babs harrison,Cocktail Hour,2001,2,10,1,1999,2
baha'u'llah,Gleanings from the Writings of Baha'u'llah,1983,2,9,1,1976,7
baha'u'llah,The Kitab-i-Aqdas: The Most Holy Book,1993,3,9,1,1983,10
bailey white,Mama Makes Up Her Mind: And Other Dangers of Southern Living,1994,2,3.6923076923076925,78,1993,1
bailey white,Sleeping at the Starlite Motel: And Other Adventures on the Way Back Home,1995,3,3.857142857142857,14,1994,1
bailey white,Sleeping at the Starlite Motel: And Other Adventures on the Way Back Home,1996,4,3.5789473684210527,19,1995,1
bailey white,Quite a Year for Plums,1998,5,2.96875,32,1996,2
bailey white,Quite a Year for Plums: A Novel,1999,6,2.3870967741935485,31,1998,1
baltasar gracian,The Art of Worldly Wisdom (Shambhala Pocket Classics),1993,2,9,1,1984,9
bancroft,A Real and Precious Thing,1994,2,0,1,1982,12
barbara ann kipfer,"Roget's 21st Century Thesaurus: In Dictionary Form : The Essential Reference for Home, School, or Office",1993,2,8.5,2,1990,3
barbara ann kipfer,"The Order of Things: How Everything in the World Is Organized...into Hierarchies, Structures, &amp; Pecking Orders",1996,3,5,2,1993,3
barbara ann kipfer,The Wish List,1997,4,4.142857142857143,14,1996,1
barbara ann kipfer,Roget's 21st Century Thesaurus : Updated &amp; Expanded 2nd Edition (21st Century Reference),1999,5,5,2,1997,2
barbara ann kipfer,Writer's Digest Flip Dictionary,2000,6,4.5,2,1999,1
barbara ann kipfer,"5,001 Things for Kids to Do",2000,7,8,1,2000,0
barbara ann kipfer,"8,789 Words of Wisdom",2001,8,4.5,2,2000,1
barbara ann kipfer,Roget's Thesaurus of Phrases,2001,9,10,1,2001,0
barbara ann kipfer,Roget's International Thesaurus,2002,10,10,1,2001,1
barbara ann kipfer,Flip Dictionary,2002,11,9,1,2002,0
barbara ann kipfer,Instant Karma,2003,12,9,1,2002,1
barbara ashmun,200 Tips for Growing Beautiful Roses,1998,2,8,1,1994,4
barbara bazaldua,Disney's Darkwing Duck in Clean Money (Golden Look-Look Books),1992,2,3.5,2,1992,0
barbara bazaldua,Walt Disney's Goofy Joke Book (A Golden Look-Look Book),1993,3,3.5,2,1992,1
barbara bazaldua,Disney's Aladdin: Monkey Business (Golden Look-Look Book),1993,4,0,2,1993,0
barbara bazaldua,Disney's the Lion King: Nala's Game (Golden Little Super Shape Books),1995,5,7,1,1993,2
barbara bazaldua,Disney's Aladdin: Mixed-Up Magic (Golden Look-Look Books),1995,6,0,1,1995,0
barbara bazaldua,Disney's Toy Story Joke Book (Golden Look-Look Books),1996,7,0,3,1995,1
barbara bazaldua,Snow Puppies (Walt Disney's 101 Dalmatians),1996,8,2.2222222222222223,9,1996,0
barbara bazaldua,The Lion King's Timon &amp; Pumbaa: You're All Wet! (Golden Look-Look Books),1996,9,1.6666666666666667,3,1996,0
barbara bazaldua,Mickey's Wish: A Deluxe Super Shape Book (Walt Disney's Mickey and Friends),1997,10,0,1,1996,1
barbara bazaldua,Quasimodo the Hero (Disney's Hunchback of Notre Dame),1997,11,7,1,1997,0
barbara bazaldua,Disney's Hercules a Race to the Rescue: A Race to the Rescue (Little Golden Book),1997,12,0,2,1997,0
barbara bazaldua,Let's Go to the Airport (A little golden book),1998,13,0,1,1997,1
barbara bazaldua,Barbie: The Jewel Thief (Reporter Series),1998,14,3,2,1998,0
barbara betcherman,Side Effects,1988,2,0,1,1980,8
barbara binswanger,On the Night the Hogs Ate Willie: And Other Quotations on All Things Southern,1994,2,0,2,1989,5
barbara brooks wallace,Hawkins,1977,2,0,1,1974,3
barbara brooks wallace,The BARREL IN THE BASEMENT,1985,3,0,1,1977,8
barbara brooks wallace,Peppermints in the Parlor,1993,4,1.25,4,1985,8
barbara brooks wallace,The Twin in the Tavern,1995,5,4,2,1993,2
barbara brooks wallace,SPARROWS IN THE SCULLERY,1999,6,0,1,1995,4
barbara brooks wallace,Miss Switch to the Rescue (Miss Switch),2002,7,0,1,1999,3
barbara burnett smith,Skeletons In Purple Sage (Worldwide Library Mysteries),2004,2,5,2,2002,2
barbara cameron,The Everything Weddings on a Budget Book: Create the Wedding of Your Dreams and Have Money Left for the Honeymoon (Everything Series),2002,2,0,1,1985,17
barbara colley,Maid for Murder (Charlotte La Rue Mysteries),2003,2,0,3,2002,1
barbara colley,Death Tidies Up (Charlotte La Rue Mysteries),2003,3,8,1,2003,0
barbara colley,Death Tidies Up,2004,4,0,2,2003,1
barbara colley,Polished Off: A Charlotte Larue Mystery (Charlotte Larue Mysteries),2004,5,9,1,2004,0
barbara dana,Zucchini,1984,2,0,1,1984,0
barbara dana,Zucchini,1984,3,8,1,1984,0
barbara dana,Young Joan,1997,4,0,3,1984,13
barbara dana,Zucchini Out West,1997,5,0,1,1997,0
barbara ehrenreich,For Her Own Good : 150 Years of the Experts' Advice to Women,1989,2,1.6,5,1984,5
barbara ehrenreich,The Worst Years of Our Lives: Irreverent Notes from a Decade of Greed,1990,3,1.5,4,1989,1
barbara ehrenreich,Fear of Falling: The Inner Life of the Middle Class,1990,4,4.5,2,1990,0
barbara ehrenreich,The Worst Years of Our Lives: Irreverent Notes from a Decade of Greed,1991,5,0,1,1990,1
barbara ehrenreich,Kipper's Game,1993,6,0,3,1991,2
barbara ehrenreich,Kipper's Game,1994,7,0,4,1993,1
barbara ehrenreich,Nickel and Dimed: On (Not) Getting By in America,2001,8,4.867647058823529,68,1994,7
barbara ehrenreich,Nickel and Dimed: On (Not) Getting By in America,2002,9,4.142322097378277,267,2001,1
barbara ehrenreich,"Global Woman: Nannies, Maids, and Sex Workers in the New Economy",2003,10,0,2,2002,1
barbara findlen,Listen Up 2 Ed: Voices from the Next Feminist Generation,2001,2,5.666666666666667,3,1995,6
barbara frischmuth,Das Heimliche und das Unheimliche: Drei Reden,1999,2,0,2,1998,1
barbara frischmuth,Das Verschwinden des Schattens in der Sonne.,2000,3,0,1,1999,1
barbara frischmuth,Einander Kind.,2000,4,0,1,2000,0
barbara frischmuth,Fingerkraut und Feenhandschuh. Sonderausgabe. Ein literarisches Gartentagebuch.,2002,5,0,1,2000,2
barbara grizzuti harrison,Italian Days,1990,2,0,1,1989,1
barbara grizzuti harrison,An Accidental Autobiography,1997,3,0,1,1990,7
barbara grizzuti harrison,Italian Days,1998,4,1.5,4,1997,1
barbara hazen,The Timid Little Kitten (Little Golden Book),1998,2,3.5,2,1977,21
barbara j. scot,Prairie Reunion,1995,2,0,1,1993,2
barbara j. scot,Prairie Reunion,1997,3,1.75,4,1995,2
barbara j. scot,The Stations of Still Creek,1999,4,5,1,1997,2
barbara j. scot,The Stations of Still Creek,2001,5,0,1,1999,2
barbara johnson,Stick A Geranium In Your Hat And Be Happy!,1990,2,4.16,25,1985,5
barbara johnson,Splashes Of Joy In The Cesspools Of Life,1992,3,1.9333333333333333,15,1990,2
barbara johnson,"Pack Up Your Gloomies In A Great Big Box, Then Sit On The Lid And Laugh!",1993,4,0.7142857142857143,7,1992,1
barbara johnson,Mama Get The Hammer! There's A Fly On Papa's Head!,1994,5,3,11,1993,1
barbara johnson,The Best of Barbara Johnson: Three Bestselling Works Complete in One Volume,1996,6,0,3,1994,2
barbara johnson,I'm So Glad You Told Me What I Didn't Wanna Hear,1996,7,2.6666666666666665,3,1996,0
barbara johnson,Living Somewhere Between Estrogen And Death,1997,8,1.8,5,1996,1
barbara johnson,Living Somewhere Between Estrogen &amp; Death,1997,9,0,1,1997,0
barbara johnson,Living Somewhere Between Estrogen and Death,1998,10,0,3,1997,1
barbara johnson,Boomerang Joy,1998,11,0,3,1998,0
barbara johnson,Christian Acts of Kindness,1999,12,10,1,1998,1
barbara johnson,He's Gonna Toot And I'm Gonna Scoot,1999,13,0,3,1999,0
barbara johnson,Daily Splashes Of Joy,2000,14,8.5,2,1999,1
barbara johnson,Leaking Laffs Between Pampers And Depends,2000,15,4.142857142857143,7,2000,0
barbara johnson,Boomerang Joy,2000,16,0,1,2000,0
barbara johnson,GodÂ¿s Most Precious Jewels Are Crystallized Tears,2001,17,9,2,2000,1
barbara johnson,Plant A Geranium In Your Cranium,2002,18,2.142857142857143,7,2001,1
barbara kuroff,1999 Novel &amp; Short Story Writer's Market (Novel and Short Story Writer's Market),1999,2,10,1,1998,1
barbara mujica,Mi hermana Frida,2002,2,0,1,2001,1
barbara mujica,Meine Schwester Frida.,2002,3,8,1,2002,0
barbara mujica,Frida,2002,4,2.923076923076923,13,2002,0
barbara mujica,Meine Schwester Frida.,2003,5,8,1,2002,1
barbara park,Beanpole,1984,2,7,1,1983,1
barbara park,Buddies,1985,3,0,3,1984,1
barbara park,Buddies,1986,4,1.5,4,1985,1
barbara park,Don't Make Me Smile,1989,5,0,1,1986,3
barbara park,My Mother Got Married: And Other Disasters (Barbara Park Reissues),1990,6,7,1,1989,1
barbara park,Don't Make Me Smile,1990,7,0,1,1990,0
barbara park,Beanpole,1990,8,0,2,1990,0
barbara park,"Maxie, Rosie, and Earl: Partners in Grime (Geek Chronicles)",1991,9,0,4,1990,1
barbara park,"Junie B. Jones and the  Stupid Smelly Bus (Junie B. Jones 1, paper)",1992,10,2.4166666666666665,12,1991,1
barbara park,"Junie B. Jones and Her Big Fat Mouth (Junie B. Jones 3, paper)",1993,11,2.230769230769231,13,1992,1
barbara park,"Junie B. Jones and a Little Monkey Business (Junie B. Jones 2, paper)",1993,12,2.25,8,1993,0
barbara park,"Junie B. Jones and  Some Sneaky Peeky Spying (Junie B. Jones 4, paper)",1994,13,4.545454545454546,11,1993,1
barbara park,"Dear God, Help! Love, Earl (Geek Chronicles)",1994,14,0,1,1994,0
barbara park,"Junie B. Jones &amp; The Yucky Blucky Fruit Cake (Junie B. Jones 5, Library Binding)",1995,15,5,1,1994,1
barbara park,"Junie B. Jones and the Yucky Blucky Fruitcake (Junie B. Jones 5, paper)",1995,16,2,4,1995,0
barbara park,Skinnybones,1995,17,3.3333333333333335,3,1995,0
barbara park,The Kid in the Red Jacket,1995,18,0,1,1995,0
barbara park,"Junie B. Jones and That Meanie Jim's B-Day (Junie B. Jones 6, paper)",1996,19,4.444444444444445,9,1995,1
barbara park,Mick Harte Was Here,1996,20,4.5,2,1996,0
barbara park,"Junie B. Jones Loves Handsome Warren (Junie B. Jones, #7)",1996,21,10,1,1996,0
barbara park,"Junie B. Jones and That Meanie Jim's Birthday (Junie B. Jones 6, Library Binding)",1996,22,0,1,1996,0
barbara park,Mick Harte Was Here,1996,23,0,2,1996,0
barbara park,"Junie B. Jones Loves Handsome Warren (Junie B. Jones 7, paper)",1996,24,2.2222222222222223,9,1996,0
barbara park,"Junie B. Jones Is A Party Animal (Junie B. Jones 10, paper)",1997,25,3.625,8,1996,1
barbara park,"Junie B. Jones Is Not A Crook (Junie B. Jones 9, paper)",1997,26,5.166666666666667,6,1997,0
barbara park,Skinnybones,1997,27,6,1,1997,0
barbara park,"Junie B. Jones Has A Monster Under Her Bed (Junie B. Jones 8, paper)",1997,28,5.5,6,1997,0
barbara park,Junie B. Jones and Some Sneaky Peeky Spying,1998,29,0,4,1997,1
barbara park,"Junie B. Jones is a Beauty Shop Guy (Junie B. Jones 11, paper)",1998,30,2.909090909090909,11,1998,0
barbara park,"Junie B. Jones Smells Something Fishy (Junie B. Jones 12, paper)",1998,31,1.1428571428571428,7,1998,0
barbara park,"Junie B. Jones is Almost Flower Girl (Junie B. Jones 13, paper)",1999,32,3.25,12,1998,1
barbara park,Junie B. Jones and That Meanie Jim's Birthday (Volume 6),1999,33,0,2,1999,0
barbara park,"Junie B. Jones and the Mushy Gushy Valentine (Junie B. Jones, Book 14)",1999,34,1,6,1999,0
barbara park,"Junie B. Jones Has a Peep In Her Pocket (Junie B. Jones 15, paper)",2000,35,4,10,1999,1
barbara park,Junie B. Jones is Captain Field Day (Junie B. Jones (Turtleback)),2000,36,5,1,2000,0
barbara park,"Junie B. Jones is Captain Field Day (Junie B. Jones 16, Library Binding)",2001,37,10,1,2000,1
barbara park,"Junie B., First Grader at Last! (Junie B. Jones, 18)",2001,38,9,2,2001,0
barbara park,Junie B. Jones Is a Graduation Girl,2001,39,2.2222222222222223,9,2001,0
barbara park,Junie B. First Grader(At Last) (Junie B Jones),2001,40,4.5,2,2001,0
barbara park,Operation: Dump the Chump,2001,41,3.5,2,2001,0
barbara park,Mick Harte Was Here,2001,42,0,3,2001,0
barbara park,Junie B. Jones Is Captain Field Day  (Junie B. Jones #16),2001,43,2,6,2001,0
barbara park,"Junie B., First Grader (At Last!)",2002,44,0,3,2001,1
barbara park,"Junie B., First Grader: Boss of Lunch (Junie B Jones)",2002,45,2.5,2,2002,0
barbara park,"Junie B., First Grader: Toothless Wonder (Junie B Jones)",2002,46,6,1,2002,0
barbara park,"Junie B., First Grader: Toothless Wonder (Junie B Jones)",2003,47,0,3,2002,1
barbara park,"Junie B., First Grader: Boss of Lunch (Junie B Jones)",2003,48,1,7,2003,0
barbara quick,Northern Edge: A Novel of Survival in Alaska's Arctic,1995,2,2,4,1990,5
barbara raskin,Hot Flashes,1988,2,0.22727272727272727,22,1987,1
barbara raskin,Hot Flashes,1988,3,0,1,1988,0
barbara raskin,Loose Ends,1988,4,1,7,1988,0
barbara raskin,Current Affairs,1990,5,1.6,5,1988,2
barbara raskin,Current Affairs,1991,6,0,2,1990,1
barbara sherrod,Gamester's Lady (Signet Regency Romance),1994,2,0,1,1994,0
barbara vine,A Dark Adapted Eye,1987,2,1.1111111111111112,9,1986,1
barbara vine,A Fatal Inversion,1987,3,2.3333333333333335,3,1987,0
barbara vine,A Fatal Inversion,1988,4,0,4,1987,1
barbara vine,The House of Stairs,1989,5,0,1,1988,1
barbara vine,Die im Dunkeln sieht man doch. Roman.,1989,6,4.6,5,1989,0
barbara vine,The House of Stairs,1990,7,1.8,5,1989,1
barbara vine,Es scheint die Sonne noch so schÃ?Â¶n. Roman.,1991,8,5.166666666666667,6,1990,1
barbara vine,Gallowglass,1992,9,2.3,10,1991,1
barbara vine,A Dark-Adapted Eye,1993,10,2.7333333333333334,15,1992,1
barbara vine,Anna's Book,1993,11,5,1,1993,0
barbara vine,King Solomon's Carpet,1993,12,4.181818181818182,11,1993,0
barbara vine,Asta's Book,1994,13,4.434782608695652,23,1993,1
barbara vine,No Night Is Too Long,1995,14,4,2,1994,1
barbara vine,No Night Is Too Long,1995,15,0.6666666666666666,9,1995,0
barbara vine,The Brimstone Wedding,1996,16,3.7142857142857144,7,1995,1
barbara vine,No Night Is Too Long,1996,17,1,8,1996,0
barbara vine,The Brimstone Wedding,1997,18,4.222222222222222,9,1996,1
barbara vine,The Brimstone Wedding,1997,19,3.272727272727273,11,1997,0
barbara vine,Keine Nacht dir zu lang.,1997,20,0,1,1997,0
barbara vine,The chimney sweeper's boy,1998,21,5.833333333333333,6,1997,1
barbara vine,The Chimney Sweeper's Boy,1998,22,5.166666666666667,6,1998,0
barbara vine,The Chimney Sweeper's Boy,1998,23,6.666666666666667,3,1998,0
barbara vine,The Chimney Sweeper's Boy,1999,24,4.714285714285714,14,1998,1
barbara vine,Schwefelhochzeit.,1999,25,0,1,1999,0
barbara vine,No Night Is Too Long,2000,26,7,1,1999,1
barbara vine,Grasshopper,2000,27,3,5,2000,0
barbara vine,Grasshopper: A Novel (Vintage Crime/Black Lizard),2002,28,2.5,4,2000,2
barbara vine,The Blood Doctor,2002,29,5.857142857142857,7,2002,0
barbara vine,The Blood Doctor : A Novel (Vintage Crime/Black Lizard),2003,30,0,7,2002,1
barbara von bellingen,Dreissig Silberlinge. Ein Roman aus der Hansezeit.,1998,2,5,1,1996,2
barbara wersba,Crazy Vanilla,1987,2,9,1,1973,14
barbara wersba,Love Is the Crooked Thing,1990,3,5,1,1987,3
barbara wilson,Walking on the Moon: Six Stories and a Novella,1983,2,7,1,1978,5
barbara wilson,Murder in the Collective,1985,3,4,4,1983,2
barbara wilson,Cora Sandel: Selected Short Stories (Women in Translation Series),1985,4,0,2,1985,0
barbara wilson,Sisters of the Road,1986,5,5.833333333333333,6,1985,1
barbara wilson,Gaudi Afternoon,1991,6,0,1,1986,5
barbara wilson,Murder in the Collective,1992,7,0,1,1991,1
barbara wilson,Trouble in Transylvania (A Cassandra Reilly Mystery),1993,8,0,1,1992,1
barbara wilson,Trouble in Transylvania: A Cassandra Reilly Mystery (Cassandra Reilly Mysteries (Paperback)),1994,9,1.1666666666666667,6,1993,1
barbara wilson,"Heartstrings (Sweet Dreams, No 219)",1994,10,0,1,1994,0
barbara wilson,If You Had a Family,1996,11,0,1,1994,2
barbara wilson,If You Had a Family,1996,12,7,1,1996,0
barbara wilson,Gaudi Afternoon: A Cassandra Reilly Mystery,2001,13,8,1,1996,5
"barbara, ph.d. keesling",Talk Sexy to the One You Love: (And Drive Each Other Wild in Bed),1996,2,0,1,1994,2
bari wood,Twins : a novel,1978,2,0,2,1977,1
bari wood,The tribe,1981,3,2.3333333333333335,3,1978,3
bari wood,The Killing Gift,1985,4,0,2,1981,4
bari wood,Tribe,1985,5,3.125,8,1985,0
bari wood,Light Source,1985,6,0.8333333333333334,6,1985,0
bari wood,Light Source,1987,7,0,1,1985,2
bari wood,Dead Ringers,1988,8,0,4,1987,1
bari wood,Amy Girl,1988,9,1.1428571428571428,7,1988,0
bari wood,Doll's Eyes,1993,10,1.25,8,1988,5
bari wood,Doll's Eyes,1994,11,2.6666666666666665,3,1993,1
bari wood,The Basement,1995,12,0,1,1994,1
bari wood,The Basement,1996,13,0,1,1995,1
barker,Case*Method: Entity Relationship Modelling,1990,2,5,1,1987,3
barker,Night Fears,1990,3,0,1,1990,0
barnaby conrad,Name Dropping: Tales from My Barbary Coast Saloon,1994,2,3,2,1990,4
barnaby conrad,Learning to Write Fiction from the Masters,1996,3,10,1,1994,2
barnaby conrad,Snoopy's Guide to the Writing Life,2002,4,10,2,1996,6
barney vinson,Las Vegas Behind the Tables,1987,2,2,3,1986,1
barrie kerper,Paris: The Collected Traveler : An Inspired Anthology &amp; Travel Resource (The Collected Traveler),2000,2,0,1,2000,0
barrie kerper,Morocco: The Collected Traveler (The Collected Traveler),2001,3,8,1,2000,1
barry clifford,The Lost Fleet: The Discovery of a Sunken Armada from the Golden Age of Piracy,2002,2,2.3333333333333335,3,1999,3
barry clifford,The Lost Fleet : The Discovery of a Sunken Armada from the Golden Age of Piracy,2003,3,0,1,2002,1
bart davis,Full Fathom Five,1987,2,0,3,1985,2
bart davis,Voyage of the Storm,1995,3,0,4,1987,8
bart davis,The Midnight Partner,1995,4,0,1,1995,0
bart kosko,Fuzzy Thinking : The New Science of Fuzzy Logic,1994,2,6.5,2,1993,1
bart kosko,Nanotime,1997,3,5,1,1994,3
bart kosko,Nanotime,1998,4,0,3,1997,1
bartholomew,"""\I Come As a Brother"""": A Remembrance of Illusions""""""",1997,2,0,2,1989,8
bathroom readers hysterical society,Uncle John's Bathroom Reader Plunges into Great Lives,2003,2,2.25,4,2002,1
bay matthews,Lessons In Loving (Silhouette Special Edition 420),1987,2,0,1,1986,1
bay matthews,"Some Warm Hunger (Silhouette Special Edition, No 391)",1987,3,0,2,1987,0
bay matthews,"Amarillo By Morning (Silhouette Special Editions, No 464)",1988,4,0,1,1987,1
bay matthews,"Summer'S Promise (Special Edition, No 505)",1989,5,0,2,1988,1
bay matthews,"Sweet Lies,Satin Sighs (Silhouette Special Edition, No. 648)",1990,6,0,1,1989,1
bay matthews,"Worth Waiting For (Silhouette Special Edition, No 825)",1993,7,0,1,1990,3
bay matthews,"Hardhearted (That Special Woman!) (Silhouette Special Edition No, 9859)",1993,8,1.5,4,1993,0
bay matthews,"Bittersweet Sacrifice (Born in the USA, 4)",1999,9,3,3,1993,6
bea sloboder,Candy Canes! (Scratch and Sniff Fun!),1996,2,0,1,1995,1
bea sloboder,The Mermaid's Ball: 20 Glitter Tattoos (Glitter Tattoos),1998,3,1,1,1996,2
beatrice coogan,The Big Wind: A Novel of Ireland,1995,2,0,1,1978,17
beatrice culleton,In Search of April Raintree,1995,2,1.3333333333333333,6,1983,12
beatrice sparks,Jay's Journal,1990,2,3.6666666666666665,9,1989,1
beatrice sparks,"It Happened to Nancy : By an Anonymous Teenager, A True Story from Her Diary (Confident Collector)",1994,3,3.9473684210526314,19,1990,4
beatrice sparks,Almost Lost : The True Story of an Anonymous Teenager's Life on the Streets (Avon Flare Book),1996,4,2,5,1994,2
beatrice sparks,Treacherous Love: The Diary of an Anonymous Teenager,2000,5,3.75,4,1996,4
beatrice sparks,Kim: Empty Inside: The Diary of an Anonymous Teenager,2002,6,7,1,2000,2
beckett publications,Beckett Almanac Of Baseball Cards And Collectibles No. 5,2000,2,10,1,1999,1
belleruth naparstek,Your Sixth Sense: Unlocking the Power of Your Intuition,1997,2,4.090909090909091,11,1995,2
belva plain,Random winds,1980,2,8,1,1978,2
belva plain,Eden burning,1982,3,0,1,1980,2
belva plain,Crescent City,1984,4,0,2,1982,2
belva plain,Golden Cup,1986,5,4.8,5,1984,2
belva plain,Golden Cup,1987,6,0.25806451612903225,31,1986,1
belva plain,Crescent City,1987,7,1.380952380952381,21,1987,0
belva plain,Eden Burning,1987,8,1,24,1987,0
belva plain,Evergreen,1987,9,2.9583333333333335,24,1987,0
belva plain,Random Winds,1987,10,1.263157894736842,19,1987,0
belva plain,Tapestry,1988,11,0,4,1987,1
belva plain,Blessings,1989,12,1.8333333333333333,6,1988,1
belva plain,Tapestry,1989,13,1.675,40,1989,0
belva plain,Harvest,1990,14,5,2,1989,1
belva plain,Blessings,1990,15,1.619047619047619,21,1990,0
belva plain,Harvest,1991,16,0.9259259259259259,27,1990,1
belva plain,Treasures,1992,17,0,3,1991,1
belva plain,Belva Plain: Three Complete Novels : Evergreen/Random Winds/Eden Burning,1993,18,4,2,1992,1
belva plain,Treasures,1993,19,1.2,45,1993,0
belva plain,Whispers,1993,20,0.8,10,1993,0
belva plain,Daybreak,1994,21,3.769230769230769,13,1993,1
belva plain,Daybreak (Bantam/Doubleday/Delacorte Press Large Print Collection),1994,22,8,1,1994,0
belva plain,Whispers,1994,23,2.236111111111111,72,1994,0
belva plain,Daybreak,1995,24,2.4594594594594597,37,1994,1
belva plain,The Carousel,1995,25,2,6,1995,0
belva plain,Promises,1996,26,4.533333333333333,15,1995,1
belva plain,Secrecy,1997,27,3.9285714285714284,14,1996,1
belva plain,Secrecy,1997,28,0,1,1997,0
belva plain,Promises,1997,29,1.7435897435897436,39,1997,0
belva plain,Homecoming,1997,30,2,26,1997,0
belva plain,Secrecy,1998,31,1.5,42,1997,1
belva plain,The Carousel,1998,32,1.8095238095238095,42,1998,0
belva plain,Homecoming,1998,33,2.1951219512195124,41,1998,0
belva plain,Legacy of Silence,1998,34,4.166666666666667,12,1998,0
belva plain,Fortune's Hand,1999,35,3.142857142857143,14,1998,1
belva plain,Legacy of Silence,1999,36,2,4,1999,0
belva plain,Legacy of Silence,1999,37,2,57,1999,0
belva plain,Fortune's Hand,1999,38,7,1,1999,0
belva plain,After the Fire,2000,39,1.8181818181818181,22,1999,1
belva plain,After the Fire,2000,40,2,1,2000,0
belva plain,Fortune's Hand,2000,41,1.2096774193548387,62,2000,0
belva plain,After the Fire,2001,42,1.8833333333333333,60,2000,1
belva plain,Looking Back,2001,43,2.6206896551724137,29,2001,0
belva plain,After the Fire,2001,44,8,1,2001,0
belva plain,Promises,2001,45,0,1,2001,0
belva plain,Looking Back,2002,46,2.303030303030303,66,2001,1
belva plain,Her Father's House,2002,47,2.72,25,2002,0
belva plain,Her Father's House,2003,48,3.4615384615384617,39,2002,1
belva plain,"The Sight of the Stars (Plain, Belva)",2003,49,2.25,8,2003,0
belva plain,"Belva Plain: Three Complete Novels : Blessings, Whispers, and Homecoming",2003,50,7,1,2003,0
ben carson,Gifted Hands,1992,2,5,2,1992,0
ben carson,Think Big,1996,3,4,2,1992,4
ben erickson,A Parting Gift,2001,2,0,2,2000,1
ben forta,Certified Macromedia ColdFusion 5 Developer Study Guide,2002,2,0,1,2001,1
ben rice,Pobby and Dingan,2003,2,8.666666666666666,3,2000,3
ben west,Fun for a Fiver or Less in Amsterdam: Hundreds of Things to Do in Amsterdam for 5 or Under,2002,2,0,2,1996,6
ben wicks,"No Time to Wave Goodbye: True Stories of Britain's 3,500,000 Evacuees",1989,2,0,1,1980,9
ben wicks,The day they took the children,1989,3,0,1,1989,0
benjamin disraeli,Sybil (Wordsworth Collection),1998,2,0,2,1993,5
benjamin e. miller,Deep Current,2004,2,0,1,2003,1
beresford,Wombles - Deep Space Wombles (Wombles S.),1999,2,5.5,2,1999,0
beresford,Wombles - Chaos on the Common (Wombles S.),1999,3,8,1,1999,0
"berez, geados bentio",Misericordia,1999,2,3.5,2,1998,1
berlie doherty,New Windmills: Granny Was a Buffer Girl (New Windmills),1988,2,7,1,1988,0
berlie doherty,Street Child,1996,3,0,1,1988,8
berlie doherty,The Snake-Stone,1996,4,0,1,1996,0
berlie doherty,The Vinegar Jar,1996,5,0,1,1996,0
berlie doherty,Daughter of the Sea (Laurel Leaf Books),2000,6,0,1,1996,4
berlie doherty,Fairy Tales,2002,7,0,1,2000,2
berlitz publishing company,"Englanti-Suomi, Suomi-Englanti Sanakirja/English-Finnish, Finnish-English Dictionary (Berlitz Pocket Dictionaries)",1980,2,0,1,1979,1
berlitz publishing company,Ibiza Travel Guide,1986,3,6,1,1980,6
berlitz publishing company,Berlitz 90 Cassettepak (Berlitz Cassettepaks),1988,4,0,1,1986,2
berlitz publishing company,The Paris Address Book (Berlitz Cityscope Series),1990,5,9,1,1988,2
berlitz publishing company,Berlitz Phrase Books: Dutch for Travellers (Berlitz Phrase Books),1990,6,0,1,1990,0
berlitz publishing company,French Phrase Book (Berlitz Phrase Books),1990,7,9,1,1990,0
berlitz publishing company,Berlitz European Phrase Book (Berlitz European Guides),1990,8,7,1,1990,0
berlitz publishing company,Berlitz Travel Guides: Prague (Berlitz Pocket Travel Guides),1990,9,7,1,1990,0
berlitz publishing company,Latin-American Spanish Phrase Book &amp; Dictionary (Berlitz Phrase Books S.),1992,10,0,1,1990,2
berlitz publishing company,Hawaii (Berlitz Travel Guide),1993,11,0,1,1992,1
berlitz publishing company,Dutch Phrase Book &amp; Dictionary,1993,12,9,1,1993,0
berlitz publishing company,Berlitz Romanian Phrase Book,1994,13,0,1,1993,1
berlitz publishing company,Berlitz French-English Dictionary (Berlitz Bilingual Dictionaries),1994,14,0,1,1994,0
berlitz publishing company,Berlitz Pocket Guide: Southern Caribbean,1994,15,5,1,1994,0
berlitz publishing company,Berlitz European Phrase Book,1995,16,0,1,1994,1
berlitz publishing company,Berlitz French Today (Berlitz Today),1998,17,0,1,1995,3
bernard asbell,Die Pille und wie sie die Welt verÃ?Â¤nderte.,1998,2,0,2,1992,6
bernard bailyn,"The Peopling of British North America: An Introduction (Curti Lectures, 1985.)",1988,2,3.5,2,1976,12
bernard bailyn,The Ideological Origins of the American Revolution,1992,3,10,2,1988,4
bernard bailyn,To Begin the World Anew: The Genius and Ambiguities of the American Founders,2003,4,0,1,1992,11
bernard cohen,Speed Factory,2002,2,0,1,1998,4
bernard goldberg,Arrogance: Rescuing America From the Media Elite,2003,2,2.5,2,2001,2
bernard goldberg,Bias : A CBS Insider Exposes How the Media Distort the News,2003,3,2.3333333333333335,12,2003,0
bernard lewis,Islam and the West,1994,2,9,1,1991,3
bernard lewis,The Middle East,1997,3,0,3,1994,3
bernard lewis,The Future of the Middle East: Predictions,1999,4,8,1,1997,2
bernard lewis,What Went Wrong: Western Impact and Middle Eastern Response,2001,5,3.8,5,1999,2
bernard lewis,"A Middle East Mosaic : Fragments of Life, Letters and History (Modern Library Classics)",2001,6,6,2,2001,0
bernard lewis,Land of Enchanters: Egyptian Short Stories from the Earliest Times to the Present Day,2001,7,0,1,2001,0
bernard lewis,What Went Wrong? Western Impact and Middle Eastern Response,2002,8,0,4,2001,1
bernard lewis,Der Untergang des Morgenlandes. Warum die islamische Welt die Vormacht verlor.,2002,9,0,1,2002,0
bernard lewis,The Crisis of Islam: Holy War and Unholy Terror,2003,10,1.25,4,2002,1
bernard lewis,What Went Wrong? : The Clash Between Islam and Modernity in the Middle East,2003,11,4,9,2003,0
bernard lewis,The Crisis of Islam : Holy War and Unholy Terror,2004,12,4,3,2003,1
bernard maclaverty,"Secrets, and other stories",1985,2,0,1,1981,4
bernard maclaverty,A Time to Dance and Other Stories,1985,3,2.6666666666666665,3,1985,0
bernard maclaverty,Cal,1995,4,4,2,1985,10
bernard maclaverty,Walking the Dog: And Other Stories,1996,5,8,1,1995,1
bernard maclaverty,Grace Notes,1997,6,4,2,1996,1
bernard maclaverty,Lamb: A Novel (Norton Paperback Fiction),1997,7,10,1,1997,0
bernard maclaverty,Grace Notes,1998,8,3,4,1997,1
bernard maclaverty,Cal (Penguin Student Editions),2000,9,0,2,1998,2
bernard mcginn,"Meister Eckhart and the Beguine Mystics: Hadewijch of Brabant, Mechthild of Magdeburg, and Marguerite Porete",1997,2,0,1,1994,3
bernard mcginn,The Doctors of the Church: Thirty-Three Men and Women Who Shaped Christianity,1999,3,0,1,1997,2
bernard palmer,Trena's Rodeo Rival (The Bradley Series),1977,2,0,1,1976,1
bernard palmer,"Kid Breckenridge (Palmer, Bernard Alvin, Breck Westerns Series, No. 3.)",1984,3,5,1,1977,7
bernard palmer,Shoot-Out at Buffalo Gulch,1985,4,0,1,1984,1
bernard palmer,"The Case of the Talking Rocks (Danny Orlis, No 5)",1989,5,0,1,1985,4
bernhard kegel,Das Ã?Â?lschieferskelett. Eine Zeitreise.,1999,2,5.166666666666667,6,1998,1
bernhard kegel,Die Ameise als Tramp. Von biologischen Invasionen.,2001,3,0,1,1999,2
bernhard kegel,Sexy Sons.,2003,4,5,1,2001,2
bernice e. cullinan,Read to Me: Raising Kids Who Love to Read,1992,2,0,5,1977,15
bernice e. cullinan,Let's Read About: Finding Books They'll Love to Read,1993,3,1.1666666666666667,6,1992,1
bernice e. cullinan,Read to Me: Raising Kids Who Love to Read,2000,4,0,1,1993,7
bernie glassman,Bearing Witness : A Zen Master's Lessons in Making Peace,1999,2,10,1,1998,1
bernie glassman,Comment accomoder sa vie Ã?Â  la maniÃ?Â¨re zen,2002,3,6,1,1999,3
bernie lee,Murder Without Reservation,1992,2,1.3333333333333333,6,1991,1
bernie lee,Murder Takes Two,1993,3,0,2,1992,1
bertolt brecht,Parables for the Theatre: Two Plays by Bertolt Brecht,1965,2,7,1,1962,3
bertolt brecht,Herr Puntila und sein Knecht Matti. VolksstÃ?Â¼ck.,1965,3,0,1,1965,0
bertolt brecht,"Baal / Der bÃ?Â¶se Baal der asoziale. Texte, Varianten, Materialien.",1968,4,0,1,1965,3
bertolt brecht,Furcht und Elend des Dritten Reiches,1970,5,0,3,1968,2
bertolt brecht,"Suhrkamp TaschenbÃ?Â¼cher, Nr.16, Geschichten vom Herrn Keuner",1971,6,0,1,1970,1
bertolt brecht,"The Jewish Wife, and Other Short Plays",1971,7,0,1,1971,0
bertolt brecht,"Collected Plays (His Plays, Poetry, &amp; Prose)",1971,8,0,1,1971,0
bertolt brecht,Collected Plays (Collected Plays),1972,9,0,1,1971,1
bertolt brecht,Collected Plays (Collected Plays),1974,10,0,1,1972,2
bertolt brecht,Gedichte (Suhrkamp-Taschenbuch ; 251),1975,11,6,1,1974,1
bertolt brecht,Two plays,1983,12,0,1,1975,8
bertolt brecht,Gedichte Ã?Â¼ber die Liebe.,1984,13,10,1,1983,1
bertolt brecht,Mother Courage and Her Children (Collected Plays),1987,14,8,2,1984,3
bertolt brecht,Galileo,1991,15,2.6,5,1987,4
bertolt brecht,Mother Courage and Her Children,1991,16,0,4,1991,0
bertolt brecht,Two Plays by Bertolt Brecht,1992,17,0,1,1991,1
bertolt brecht,The Threepenny Opera,1994,18,10,1,1992,2
bertolt brecht,The Caucasian Chalk Circle,1994,19,1.75,4,1994,0
bertolt brecht,The Good Person of Szechwan,1994,20,0,1,1994,0
bertolt brecht,Brecht- Liederbuch.,1998,21,8,1,1994,4
bertolt brecht,Der Kaukasische Kreidekreis,1998,22,3,3,1998,0
bertolt brecht,Dans la jungle des villes,1998,23,0,1,1998,0
bertolt brecht,Die Gewehre der Frau Carrar.,1999,24,0,3,1998,1
bertolt brecht,"Edition Suhrkamp, Nr.49, Mutter Courage und ihre Kinder",2001,25,1.6,5,1999,2
bertolt brecht,Poemas y Canciones,2001,26,7,2,2001,0
bertolt brecht,"Edition Suhrkamp, Nr.1, Leben des Galilei",2002,27,3.5714285714285716,7,2001,1
bertolt brecht,Der kaukasische Kreidekreis. Text und Kommentar. (Lernmaterialien),2003,28,0,1,2002,1
beryl cook,Private View,1981,2,9,1,1978,3
beryl cook,Bouncers,1993,3,10,1,1981,12
beth bosworth,Tunneling : A Novel,2003,2,0,1,1995,8
beth gutcheon,Without a Trace,1983,2,0,2,1981,2
beth gutcheon,Domestic Pleasures: A Novel,1991,3,2.3333333333333335,3,1983,8
beth gutcheon,Domestic Pleasures,1992,4,1,7,1991,1
beth gutcheon,Saying Grace: A Novel,1995,5,3.5,4,1992,3
beth gutcheon,Saying Grace,1996,6,2.3333333333333335,6,1995,1
beth gutcheon,Still Missing,1996,7,3.8,15,1996,0
beth gutcheon,The New Girls,1996,8,3.5,14,1996,0
beth gutcheon,Five Fortunes : A Novel,1998,9,4.142857142857143,7,1996,2
beth gutcheon,Five Fortunes,1999,10,1,21,1998,1
beth gutcheon,More Than You Know: A Novel,2000,11,2.588235294117647,34,1999,1
beth gutcheon,Das Schulhaus.,2001,12,8,1,2000,1
beth gutcheon,Domestic Pleasures : A Novel,2001,13,1.2727272727272727,11,2001,0
beth gutcheon,More Than You Know: A Novel,2001,14,3.1176470588235294,34,2001,0
beth saulnier,Distemper (Alex Bernier Mysteries),2000,2,7.5,2,1999,1
beth saulnier,The Fourth Wall,2001,3,5.333333333333333,3,2000,1
beth saulnier,Bad Seed: An Alex Bernier Mystery,2002,4,2.25,4,2001,1
beth saulnier,Bad Seed,2003,5,8,1,2002,1
beth saulnier,Ecstasy,2003,6,9,1,2003,0
betina krahn,Love's Brazen Fire (A Zebra Romance),1990,2,0,2,1987,3
betina krahn,The Princess and the Barbarian,1993,3,0,3,1990,3
betina krahn,Midnight Magic,1995,4,0,2,1993,2
betina krahn,Hidden Fires,1995,5,2,3,1995,0
betina krahn,The Unlikely Angel,1996,6,2.4,10,1995,1
betina krahn,Love's Brazen Fire,1997,7,2.25,4,1996,1
betina krahn,Just Say Yes (Zebra Historical Romance),2002,8,0,1,1997,5
betina krahn,Passion's Ransom (Zebra Historical Romance),2002,9,7,1,2002,0
betina krahn,Luck Be a Lady,2002,10,2.6666666666666665,6,2002,0
betina krahn,The Wife Test,2003,11,2.875,16,2002,1
betina krahn,The Paradise Bargain,2003,12,1.6666666666666667,3,2003,0
betina krahn,The Marriage Test,2004,13,4.8,5,2003,1
betsy lerner,The Forest for the Trees: An Editor's Advice to Writers,2001,2,4,2,2000,1
betsy lerner,Food and Loathing: A Lament,2003,3,2.3333333333333335,9,2001,2
betsy lerner,Food and Loathing : A Life Measured Out in Calories,2004,4,3,4,2003,1
betsy lifton,Show Time! (Not for Blondes Only),1992,2,0,1,1992,0
better homes&gardens,Christmas Trims Kids Can Make,1988,2,0,1,1982,6
bettina paterson,My Toys,1992,2,0,1,1992,0
bettina paterson,Merry Christmas Santa,1992,3,0,1,1992,0
bettina paterson,Potty Time (Teddy Board Book),1993,4,0,1,1992,1
bettina paterson,Duckling's Surprise,1995,5,0,1,1993,2
bettina paterson,Santa's Little Elf,1995,6,0,1,1995,0
bettina paterson,Nice New Shoes (Teddy Board Book),1995,7,7,1,1995,0
bettina paterson,Little Hippo Lift The Flap Book (Where's Teddy) (Play with S.),1999,8,10,1,1995,4
bettina selby,Riding the Desert Trail,1993,2,5,1,1991,2
bettina selby,Pilgrim's Road: A Journey to Santiago De Compostela,1995,3,0,1,1993,2
betty harper fussell,My Kitchen Wars,1999,2,3.5,2,1986,13
betty jean lifton,Zweimal geboren. Memoiren einer Adoptivtochter.,1981,2,9,1,1979,2
betty jean lifton,Adoption.,1982,3,0,1,1981,1
betty jean lifton,I'm Still Me,1986,4,0,3,1982,4
betty jean lifton,Journey of the Adopted Self: A Quest for Wholeness,1995,5,9,1,1986,9
betty lehan harragan,Games Mother Never Taught You: Corporate Gamesmanship for Women,1978,2,7,1,1978,0
betty lehan harragan,Games Mother Never Taught You,1978,3,0,1,1978,0
betty lehan harragan,Games Mother Never Taught You,1989,4,0,1,1978,11
betty miles,The Trouble with Thirteen,1979,2,0,1,1978,1
betty miles,The Secret Life of the Underwear Champ (Capers),1981,3,0,1,1979,2
betty miles,I Would If I Could,1983,4,0,1,1981,2
betty miles,Trouble With Thirteen,1985,5,3,5,1983,2
betty miles,All It Takes Is Practice,1987,6,0,1,1985,2
betty miles,Maudie and Me and the Dirty Book,1987,7,0,1,1987,0
betty miles,The Trouble With Thirteen,1989,8,8,1,1987,2
betty miles,"REAL ME, THE",1989,9,0,2,1989,0
betty miles,Looking on,1989,10,0,1,1989,0
betty miles,Hey IM Reading,1995,11,2.5,2,1989,6
betty miles,The Real Me,2000,12,5,2,1995,5
betty white,Betty White's Pet-Love: How Pets Take Care of Us,1985,2,6,1,1976,9
betty white,Betty White's Pet-Love: How Pets Take Care of Us,1987,3,0,2,1985,2
betty white,Betty White in Person,1987,4,2.5,2,1987,0
betty white,Betty White: In Person,1988,5,0,3,1987,1
betty white,The Leading Lady: Dinah's Story,1991,6,2.5,2,1988,3
betty white,The Leading Lady: Dinah's Story,1993,7,0,1,1991,2
betty white,HERE WE GO AGAIN : My Life In Television (A LISA DREW BOOK),1995,8,3.25,4,1993,2
betty white,Here We Go Again: My Life in Television (Here We Go Again),1997,9,4,2,1995,2
bettyclare moffatt,Opening to Miracles: True Stories of Blessings and Renewal,1995,2,0,1,1994,1
beverly brandt,Record Time,2002,2,3.75,12,2002,0
beverly brandt,Room Service,2003,3,2.5555555555555554,9,2002,1
beverly brandt,Dream On,2004,4,3.3333333333333335,3,2003,1
beverly byrne,Fiery Splendor,1983,2,0,1,1981,2
beverly byrne,Women's Rites,1985,3,0,2,1983,2
beverly byrne,Women's Rites,1986,4,0,2,1985,1
beverly byrne,Come Sunrise,1987,5,1.25,4,1986,1
beverly byrne,A Matter of Time,1987,6,0,1,1987,0
beverly byrne,A Matter of Time,1988,7,0,1,1987,1
beverly byrne,Morgan Women,1990,8,5,1,1988,2
beverly byrne,A Lasting Fire,1991,9,0,3,1990,1
beverly byrne,The Flames of Vengeance,1991,10,0,2,1991,0
beverly byrne,The Firebirds,1992,11,0,2,1991,1
beverly connor,Dressed to Die: A Lindsay Chamberlain Novel,2001,2,4,2,2001,0
beverly connor,A Rumor of Bones (Lindsay Chamberlain Mysteries (Paperback)),2001,3,0,2,2001,0
beverly connor,Airtight Case: A Lindsay Chamberlain Novel,2002,4,4,2,2001,1
beverly connor,Skeleton Crew: A Lindsay Chamberlain Novel,2002,5,4.75,4,2002,0
beverly connor,One Grave Too Many,2003,6,3.4285714285714284,7,2002,1
beverly connor,Dead Guilty,2004,7,9,1,2003,1
beverly daniel tatum,Why Are All the Black Kids Sitting Together in the Cafeteria? And Other Conversations About Race,1999,2,3,3,1997,2
beverly daniel tatum,"Why Are All The Black Kids Sitting Together In The Cafeteria? And Other Conversations About Race: A Psychologist Explains the Development of Racial Identity, Revised edition",2003,3,0,1,1999,4
beverly hastings,Watcher in the Dark,1991,2,0,1,1985,6
beverly hastings,Somebody Help Me,1993,3,2,2,1991,2
beverly hastings,No Way Out,1994,4,8,1,1993,1
beverly hastings,Promise Not to Tell,1995,5,0,1,1994,1
beverly s. martin,Juffie Kane,1990,2,1.1666666666666667,6,1989,1
beverly s. martin,Juffie Kane,1991,3,0,1,1990,1
beverly sommers,Unscheduled Love (Harlequin American Romance),1983,2,0,2,1982,1
beverly sommers,"Mix and Match (Harlequin American Romance, No. 85)",1984,3,0,1,1983,1
beverly sommers,Ride Painted Pony (Harlequin American Romance Premier Edition),1984,4,0,1,1984,0
beverly sommers,Passing Game,1984,5,0,3,1984,0
beverly sommers,Changing Places (Harlequin American Romance),1985,6,0,1,1984,1
beverly sommers,"Silent Night (Harlequin American Romance, No 179)",1986,7,0,1,1985,1
beverly sommers,"Reason To Believe (Silhouette Intimate Moments, No 164)",1986,8,0,3,1986,0
beverly sommers,"Starting Over (Keepsake, No 3)",1987,9,0,1,1986,1
beverly sommers,"Reach For The Sky (Harlequin American Romance, No 258)",1988,10,1.75,4,1987,1
beverly sommers,"Getting Even (American Romance, No 313)",1989,11,0,2,1988,1
beverly sommers,"Little Rebellion (American Romance, No 298)",1989,12,0,1,1989,0
beverly sommers,"Outside In (Harlequin American Romance, 331)",1990,13,0,1,1989,1
beverly sommers,"Corrupted (Silhouette Intimate Moments, No 333)",1990,14,0,5,1990,0
beverly sommers,The Meaning of Sisterhood,1993,15,0,1,1990,3
beverly sommers,Minor Adjustments,1993,16,0,2,1993,0
bill baldwin,The Trophy,1989,2,0,1,1987,2
bill baldwin,"The Defiance (Helmsman Series , No 7)",1996,3,0,1,1989,7
bill blum,Prejudicial,1996,2,1.4,5,1995,1
bill blum,The Last Appeal,1997,3,1.8571428571428572,7,1996,1
bill blum,The Face of Justice,1998,4,0,6,1997,1
bill clinton,The Starr Evidence,1998,2,2.3333333333333335,3,1992,6
bill clinton,My Life,2004,3,0.5,2,1998,6
bill clinton,My Life,2004,4,4,1,2004,0
bill clinton,My Life,2004,5,1.9565217391304348,23,2004,0
bill drummond,Manual: How to Have a Number 1 the Easy Way,1999,2,0,1,1996,3
bill drummond,45,2001,3,1.75,4,1999,2
bill drummond,Bad Wisdom,2003,4,5,2,2001,2
bill farrel,Men Are Like Waffles -  Women Are Like Spaghetti,2001,2,4,2,1997,4
bill fleming,The Tiger on Your Couch: What the Big Cats Can Teach You About Living in Harmony With Your House Cat,1994,2,0,1,1992,2
bill gates,The Road Ahead,1995,2,0,1,1995,0
bill gates,The Road Ahead (CD ROM included),1996,3,2.6666666666666665,15,1995,1
bill gates,The Road Ahead,1996,4,2.8,5,1996,0
bill gates,Der Weg nach vorn. Die Zukunft der Informationsgesellschaft.,1997,5,0,2,1996,1
bill gates,Business @ the Speed of Thought : Using a Digital Nervous System,1999,6,2,2,1997,2
bill gates,Business @ the Speed of Thought : Using a Digital Nervous System,1999,7,1.1428571428571428,14,1999,0
bill gates,Business @ the Speed of Thought: Succeeding in the Digital Economy,2000,8,0,1,1999,1
bill givens,Film Flubs: The Sequel : Even More Memorable Movie Mistakes,1992,2,8,1,1991,1
bill givens,Roman Soldiers Don't Wear Watches: 333 Film Flubs-Memorable Movie Mistakes,1996,3,7,1,1992,4
bill givens,Reel Gags,1998,4,0,1,1996,2
bill martin,The Maestro Plays,1994,2,7,1,1991,3
bill mccarty,"Learning Red Hat Linux, 2nd Edition",2002,2,7.5,2,1999,3
bill moeller,Complete Guide to Full-Time Rving: Life on the Open Road,1998,2,6.5,2,1993,5
bill murphy,Tin Kickers,2000,2,0,1,1999,1
bill murphy,HOME TRUTHS,2000,3,0,1,2000,0
bill murphy,Fractions of Zero,2001,4,0,1,2000,1
bill naughton,Alfie,2001,2,8,2,1999,2
bill press,Spin This! All the Ways We Don't Tell the Truth,2002,2,0,2,2001,1
bill ransom,Jaguar,1990,2,8.666666666666666,3,1988,2
bill ransom,Viravax (Ace Science Fiction),1993,3,0,2,1990,3
bill ransom,Viravax,1994,4,0,2,1993,1
bill ransom,Burn,1995,5,7,1,1994,1
bill ransom,Burn: A Novel,1996,6,0,2,1995,1
bill russell,Russell Rules: 11 Lessons on Leadership from the Twentieth Century's Greatest Winner,2002,2,0,1,2001,1
bill yenne,Joseph and the Coat of Many Colors (Children's Bible Classics),1994,2,0,1,1990,4
bill yenne,Lost Treasure: A Guide to Buried Riches,1999,3,0,2,1994,5
billie holiday,Lady Sings the Blues,1998,2,6,1,1995,3
billy mills,Die Suche nach dem verborgenen GlÃ?Â¼ck.,2002,2,0,1,1991,11
birnbaum,"Birnbaum's Disneyland Resort 2004 : Expert Advice from the Inside Source (Birnbaum's Disneyland, 2004)",2003,2,0,1,2002,1
bjorn kurten,Dance of the Tiger,1983,2,0,2,1981,2
bjorn kurten,The Innocent Assassins,1991,3,0,1,1983,8
bjorn kurten,Dance of the Tiger: A Novel of the Ice Age,1995,4,4.5,2,1991,4
bjorn kurten,Before the Indians,1996,5,0,1,1995,1
blaine m. yorgason,Secrets,1992,2,9,1,1983,9
blaine m. yorgason,One Tattered Angel: A True Story,1995,3,0,1,1992,3
blaine m. yorgason,"The Soderberg Saga: Includes: The Bishop's Horse Race, Brother Brigham's Gold, Seven Days for Ruby, &amp; in Search of Steenie Bergman",1995,4,0,1,1995,0
blaine m. yorgason,At All Hazards (Hearts Afire),1997,5,7,1,1995,2
blaine m. yorgason,Gabriel's Well,2000,6,2.6,5,1997,3
blanche fisher wright,The Real Mother Goose,1994,2,5,1,1992,2
blanche fisher wright,The Real Mother Goose,1994,3,5,2,1994,0
blanche fisher wright,The Real Mother Goose (Real Mother Goose Library),1998,4,0,1,1994,4
blanche mccrary boyd,Terminal Velocity,1997,2,0,2,1995,2
blanche mccrary boyd,Terminal Velocity,1998,3,0,1,1997,1
blanche mccrary boyd,Terminal Velocity,1999,4,0,1,1998,1
blossom elfman,First Love Lives Forever,1987,2,0,1,1979,8
bo niles,Life is Too Short...,1994,2,0,1,1988,6
bo niles,The New York Book of Coffee and Cake,1995,3,0,1,1994,1
bo niles,The New York Book of Tea: Where to Take Tea and Buy Tea &amp; Teaware,1997,4,7,1,1995,2
bob barner,To Everything,1998,2,0,1,1990,8
bob brier,The Murder of Tutankhamen: A True Story,1999,2,2.3333333333333335,3,1998,1
bob deits,"Life After Loss: A Personal Guide Dealing With Death, Divorce, Job Change and Relocation, Third Edition",1999,2,1.3333333333333333,3,1992,7
bob hill,Double Jeopardy,1996,2,0.875,8,1995,1
bob norris,Fly-Off,1999,2,4,2,1998,1
bob ottum,Big and Little Are Not the Same,1994,2,0,1,1975,19
bob phillips,The Best of the Good Clean Jokes,1989,2,0,2,1978,11
bob phillips,In Search of Bible Trivia/Believers Edition,1989,3,0,1,1989,0
bob phillips,The Delicate Art of Dancing With Porcupines: Learning to Appreciate the Finer Points of Others,1989,4,0,1,1989,0
bob phillips,Heavenly Fun,1990,5,0,2,1989,1
bob phillips,The All New Clean Joke Book,1990,6,2.5,4,1990,0
bob phillips,Good Clean Jokes for Kids,1991,7,8,1,1990,1
bob phillips,Encyclopedia of Good Clean Jokes,1992,8,0,1,1991,1
bob phillips,Awesome Good Clean Jokes for Kids,1992,9,2.8,5,1992,0
bob phillips,"Phillips' Book of Great Thoughts Funny Sayings: A  Stupendous Collection of Quotes, Quips, Epigrams, Witticisms, and Humorous Comments. for Personal",1993,10,7.4,5,1992,1
bob phillips,Ultimate Good Clean Jokes for Kids,1993,11,0,3,1993,0
bob phillips,The Awesome Book of Bible Trivia,1994,12,9,1,1993,1
bob phillips,What to Do Until the Psychiatrist Comes,1995,13,0,1,1994,1
bob phillips,Jest Another Good Clean Joke Book,1996,14,4,2,1995,1
bob phillips,The World's Greatest Collection of Knock Knock Jokes: And Tongue Twisters,1998,15,0,3,1996,2
bob phillips,World's Greatest Collection of Clean Jokes,1998,16,0,4,1998,0
bob phillips,Over the Hill &amp; on a Roll,1998,17,0,3,1998,0
bob phillips,Phillips' Awesome Collection of Quips &amp; Quotes: Words to Laugh and Live by from A to Z,2001,18,7,1,1998,3
bob phillips,42 Days to Feeling Great,2001,19,0,1,2001,0
bob scher,Lightning: The Nature of Leadership,2003,2,10,1,1993,10
bob staake,My Little Opposites Book (Board Book Series),2001,2,0,1,1996,5
bobby jaye allen,Every First Saturday,2002,2,8.5,2,2002,0
bobby jaye allen,On the Chopping Block,2003,3,8,1,2002,1
bonnie angelo,First Mothers: The Women Who Shaped the Presidents,2001,2,2.6666666666666665,3,2000,1
bonnie bryant hiller,Trail Mates (The Saddle Club),1989,2,0,1,1989,0
bonnie bryant hiller,Horse Shy (The Saddle Club),1989,3,7,1,1989,0
bonnie bryant hiller,Team Play (The Saddle Club),1991,4,2.3333333333333335,3,1989,2
bonnie bryant hiller,Rodeo Rider (The Saddle Club),1991,5,5,1,1991,0
bonnie bryant hiller,Horse Wise (The Saddle Club),1991,6,7,1,1991,0
bonnie bryant hiller,Race Horse (The Saddle Club),1992,7,0,1,1991,1
bonnie k. winn,"When A Man Loves A Woman  (Maybe This Time) (Harlequin American Romance, No 646)",1996,2,0,2,1996,0
bonnie k. winn,"Daddy Factor (Harlequin American, No 680)",1997,3,0,6,1996,1
bonnie k. winn,"His - And - Hers Family (Harlequin American Romance, No 720)",1998,4,0,1,1997,1
bonnie k. winn,"Hijacked Wife  (Families Are Forever) (Silhouette Intimate Moments, 954)",1999,5,0,1,1998,1
bonnie k. winn,"Accidental Mrs Mackenzie (Harlequin American Romance, 775)",1999,6,4,4,1999,0
bonnie k. winn,"Wrong Brother (Twins) (Superromance, 898)",2000,7,2,3,1999,1
bonnie k. winn,"Mommy Makeover (Harlequin American Romance, 812)",2000,8,0,1,2000,0
bonnie k. winn,For the Sake of His Child (Harlequin Superromance),2004,9,5,2,2000,4
bonnie miller rubin,Quick Escapes Chicago,2000,2,8,1,1998,2
bonnie pega,"The Rebel and His Bride (Loveswept, No 773)",1995,2,0,1,1993,2
bonnie ramthun,Earthquake Games,2000,2,0,1,1999,1
bonnie ramthun,Ground Zero,2000,3,1.3333333333333333,12,2000,0
bonnie ramthun,Earthquake Games,2001,4,2,6,2000,1
bonnie s. anderson,Create Your Own Life Writings,2001,2,0,1,1989,12
bonnie stern,Bonnie Stern's Essentials of Home Cooking,2003,2,8,1,1985,18
bonnie stern,Simply Heartsmart Cooking,2003,3,5,1,2003,0
boris leonidovich pasternak,Dr Zhivago,1983,2,1.5,4,1958,25
boris leonidovich pasternak,Doctor Zhivago,1990,3,0,10,1983,7
boris leonidovich pasternak,Doctor Zhivago (The World's best reading),1990,4,0,3,1990,0
boris leonidovich pasternak,Doctor Zhivago,1991,5,0,1,1990,1
boris leonidovich pasternak,Doctor Zhivago (Everyman's library),1991,6,0,1,1991,0
boris leonidovich pasternak,"Doctor Zhivago (Everyman's Library Series, Vol. 41)",1991,7,1.1666666666666667,6,1991,0
boris pasternak,The Last Summer (Peter Owen Modern Classic),2001,2,7,1,1997,4
boris pasternak,"Infancia de Liuvers, La",2001,3,8,1,2001,0
boris starling,Storm,2000,2,2.5416666666666665,24,1999,1
brad anderson,Marmaduke...Again,1988,2,0,1,1976,12
brad barkley,Alison's Automotive Repair Manual : A Novel,2004,2,0,1,2003,1
brad densmore,Nelson's Amazing Bible Trivia Book One,1999,2,3,2,1998,1
brad sears,"Last Chance Garage: A System-By-System Guide to Understanding How Your Car Runs, Why It Occasionally Doesn't, and What You Can Do about It",1984,2,5,2,1984,0
bradbury,Fahrenheit 451,1977,2,7.2,5,1976,1
bradbury,October Country,1978,3,0,1,1977,1
bradbury,Santa Claus Has a Busy Night (Series S808),1985,4,0,1,1978,7
brady udall,The Miracle Life of Edgar Mint: A Novel,2001,2,3.6,5,1998,3
brady udall,The Miracle Life of Edgar Mint: A Novel,2002,3,3.220779220779221,77,2001,1
brady udall,Le Destin miraculeux d'Edgar Mint,2003,4,4,2,2002,1
bradygames,PlayStation 2 Secret Codes 2002,2002,2,8,1,1999,3
bradygames,Secret Codes 2003,2002,3,4,1,2002,0
brandner,Howling 2,1981,2,0,1,1981,0
brenda clarke,Sweet Auburn,1995,2,0,1,1995,0
brenda cole,"Alabama Night (Crosswinds, No 37)",1988,2,0,1,1987,1
brenda peterson,Sister Stories: Taking the Journey Together,1996,2,10,1,1990,6
brenda peterson,Sister Stories: Taking the Journey Together,1997,3,0,1,1996,1
brenda peterson,Build Me an Ark: A Life with Animals,2001,4,9,1,1997,4
brenda wilbee,Sweetbriar Bride (#2 Seattle Sweetbriar Series/Brenda Wilbee),1986,2,0,1,1983,3
brenda wilbee,Sweetbriar Spring (#3 Seattle Sweetbriar Series/Brenda Wilbee),1989,3,0,1,1986,3
brenda wilbee,Taming the Dragons: Christian Women Resolving Conflict,1992,4,0,2,1989,3
brendan o'carroll,The Chisellers,1995,2,0,1,1994,1
brendan o'carroll,SparrowÂ§s trap,1997,3,8,1,1995,2
brendan o'carroll,The Mammy,1999,4,4.204545454545454,44,1997,2
brendan o'carroll,The Granny,1999,5,8,1,1999,0
brendan o'carroll,The Granny,2000,6,2.230769230769231,13,1999,1
brendan o'carroll,The Chisellers,2000,7,2.5714285714285716,14,2000,0
brendan o'carroll,Agnes Browne,2000,8,2.4,15,2000,0
brendan o'carroll,The Young Wan: An Agnes Browne Novel,2004,9,1,8,2000,4
brenna lyons,Prophecy: Rapture,2004,2,10,1,2003,1
brenna lyons,Fion's Daughter,2004,3,0,1,2004,0
brennan manning,The Ragamuffin Gospel,1990,2,4.181818181818182,11,1981,9
brennan manning,The Signature of Jesus,1992,3,0,1,1990,2
brennan manning,Abba's Child: The Cry of the Heart for Intimate Belonging,1994,4,0,3,1992,2
brennan manning,The Signature Of Jesus,1996,5,7,1,1994,2
brennan manning,Reflections for Ragamuffins: Daily Devotions from the Writings of Brennan Manning,1998,6,8,1,1996,2
brennan manning,The Ragamuffin Gospel,2000,7,4.4,10,1998,2
brennan manning,The Boy Who Cried Abba: A Parable of Trust and Acceptance,2001,8,10,1,2000,1
brennan manning,Ruthless Trust : The Ragamuffin's Path to God,2002,9,10,1,2001,1
brennan manning,The Wisdom of Tenderness : What Happens When God's Fierce Mercy Transforms Our Lives,2002,10,0,1,2002,0
brennan manning,A Glimpse of Jesus : The Stranger to Self-Hatred,2003,11,0,1,2002,1
brennan manning,The Rabbi's Heartbeat,2003,12,8,1,2003,0
brett butler,Knee Deep in Paradise,1996,2,3.5714285714285716,21,1996,0
brett butler,Knee Deep in Paradise,1997,3,1.4,5,1996,1
brian ball,Cat Up the Clock (Hedgehogs),1990,2,0,1,1978,12
brian callison,The Trojan Hearse,1991,2,4,1,1989,2
brian craig,The Wine of Dreams,2000,2,0,1,1994,6
brian craig,"Pawns of Chaos (Warhammer 40,000 Novels)",2001,3,3,1,2000,1
brian fawcett,Public Eye: An Investigation into the Disappearance of the World,1990,2,0,2,1986,4
brian fawcett,CATS IN SPACE...AND OTHER PLACES,1992,3,2,8,1990,2
brian fawcett,Virtual Clearcut or the Way Things Are in My Hometown,2003,4,0,2,1992,11
brian hodge,Dark Advent,1988,2,0,1,1988,0
brian hodge,Nightlife,1991,3,0,2,1988,3
brian hodge,Death Grip,1992,4,0,2,1991,1
brian hodge,The Darker Saints,1993,5,1.3333333333333333,3,1992,1
brian hodge,Wild Horses,1999,6,2.25,4,1993,6
brian hunter,The Statesman's Year-Book: Statistical and Historical Annual of the States of the World for the Year 1995-1996 (Statesman's Year-Book),1995,2,0,1,1991,4
brian kilcommons,"Good Owners, Great Cats",1995,2,0,1,1994,1
brian kilcommons,Tails from the Barkside,1997,3,3.4,5,1995,2
brian kilcommons,"Good Owners, Great Dogs",1999,4,8.666666666666666,3,1997,2
brian kilcommons,Paws to Consider : Choosing the Right Dog for You and Your Family,1999,5,10,1,1999,0
brian kilcommons,Metrodog : The Essential Guide to Raising Your Dog in the City,2001,6,5,2,1999,2
brian lowry,"Trust No One (The Official Guide to the X-Files, Vol. 2)",1996,2,3.5833333333333335,12,1995,1
brian lysaght,EYE OF THE BEHOLDER,1997,2,0,1,1986,11
brian masters,Killing for Company: The Story of a Man Addicted to Murder,1994,2,0,4,1993,1
brian masters,Georgiana,1997,3,0,1,1994,3
brian stewart,The Enid Blyton Dossier,1998,2,0,1,1988,10
brian williams,The Light and Shadow Tarot,1996,2,0,1,1994,2
brian williams,Tutankhamen (Historical Biographies),2002,3,10,1,1996,6
brian williams,Sport and Entertainment (Biggest &amp; Best Series),2003,4,0,1,2002,1
brian williams,The Way We Live: Biggest &amp; Best (Biggest &amp; Best series),2004,5,0,1,2003,1
brigitte weninger,"Will You Mind the Baby, Davy? (Michael Neugebauer Book)",2000,2,10,1,1999,1
brindley louise,Louise Brindley Omnibus (Pb),2000,2,5,1,1999,1
british museum,Dinosaurs and Their Living Relatives (Natural History Series),1986,2,9,1,1972,14
british museum,Man's Place in Evolution (Natural History Museum Publications),1991,3,10,1,1986,5
british museum,The Celts Activity Book,2000,4,9,1,1991,9
brock thoene,Saga of the Sierras/Boxed Set of 3 (Volume No. 5-7),1994,2,0,1,1990,4
brock thoene,The Legend of Storey County: A Novel,1995,3,7,1,1994,1
brock thoene,Hope Valley War,1996,4,0,2,1995,1
brock thoene,Shiloh Autumn,1997,5,0,2,1996,1
brother andrew,The Narrow Road : Stories of Those Who Walk This Road Together,2001,2,10,1,1967,34
bruce alexander,Murder in Grub Street,1995,2,8,1,1994,1
bruce alexander,Blind Justice (Sir John Fielding Mysteries (Paperback)),1995,3,2.1,10,1995,0
bruce alexander,Murder in Grub Street (Sir John Fielding Mysteries (Paperback)),1996,4,1.7,10,1995,1
bruce alexander,Die zweite Wahrheit.,1997,5,0,1,1996,1
bruce alexander,Watery Grave (Sir John Fielding Mysteries (Paperback)),1997,6,4,6,1997,0
bruce alexander,Person or Persons Unknown (Sir John Fielding Mysteries (Paperback)),1998,7,0,2,1997,1
bruce alexander,"Jack, Knave and Fool",1999,8,1.25,4,1998,1
bruce alexander,"Jack, Knave and Fool (Thorndike Large Print Basic Series)",1999,9,0,1,1999,0
bruce alexander,Death of a Colonial,2000,10,0,3,1999,1
bruce alexander,The Color of Death (Sir John Fielding Mysteries (Paperback)),2001,11,2.6666666666666665,3,2000,1
bruce alexander,Smuggler's Moon: A Sir John Fielding Mystery (Sir John Fielding Mysteries (Hardcover)),2001,12,0,1,2001,0
bruce alexander,La Veuve et l'Imposteur,2001,13,0,1,2001,0
bruce alexander,Das letzte Konzert.,2001,14,5,1,2001,0
bruce alexander,Smuggler's Moon,2002,15,1.4,5,2001,1
bruce alexander,TÃ?Â¶dliche Erbschaft. Ein Richter- Fielding- Roman.,2002,16,5,1,2002,0
bruce alexander,Experiment in Treason (Sir John Fielding Mysteries (Hardcover)),2002,17,4.5,2,2002,0
bruce alexander,An Experiment in Treason,2003,18,0,1,2002,1
bruce alexander,The Price of Murder (Sir John Fielding Mysteries (Hardcover)),2003,19,9,1,2003,0
bruce bagemihl,Biological Exuberance: Animal Homosexuality and Natural Diversity,2000,2,10,1,1998,2
bruce cole,ART OF THE WESTERN WORLD: FROM ANCIENT GREECE TO POST MODERNISM,1991,2,0,1,1989,2
bruce cole,The Pumpkinville Mystery,1991,3,8,1,1991,0
bruce eric kaplan,The Cat That Changed My Life : 50 Cats Talk Candidly About How They Became Who They Are,2004,2,0,1,2002,2
bruce jr. bliven,"The Story of D-Day: June 6, 1944 (Landmark Books (Paperback))",1991,2,0,1,1987,4
bruce m. nash,Haunted Kids,1993,2,0,4,1978,15
bruce m. nash,Spooky Kids: Strange but True Tales,1994,3,2.5,2,1993,1
bruce m. nash,"Lawyer's Wit and Wisdom: Quotations on the Legal Profession, in Brief",1995,4,0,1,1994,1
bruce narramore,Why Children Misbehave: A Guide to Positive Parenting,2000,2,8,1,1992,8
bruce nussbaum,Good Intentions: How Big Business and the Medical Establishment Are Corrupting the Fight Against AIDS,1991,2,0,2,1983,8
bruno bettelheim,On Learning to Read: The Child's Fascination With Meaning,1981,2,7,1,1980,1
bruno bettelheim,The Informed Heart: Autonomy in a Mass Age,1985,3,9,1,1981,4
bruno bettelheim,The Uses of Enchantment,1988,4,3.2,10,1985,3
bruno bettelheim,The Uses of Enchantment: The Meaning and Importance of Fairy Tales,1989,5,5,2,1988,1
bruno bettelheim,Psychanalyse des contes de fÃ?Â©es,1999,6,8,1,1989,10
bryan woolley,November 22,1982,2,0,1,1974,8
bryan woolley,Some Sweet Day,1996,3,6,1,1982,14
bud e.  smith,Creating Web Graphics for Dummies,2003,2,4,2,2002,1
budd schulberg,Moving Pictures: Memories of a Hollywood Prince,1984,2,9,1,1975,9
budd schulberg,The Harder They Fall: A Novel,1996,3,0,1,1984,12
budd schulberg,What Makes Sammy Run?,2002,4,8,1,1996,6
burne hogarth,Tarzan of the apes,1972,2,0,1,1970,2
burne hogarth,Drawing Dynamic Hands,1977,3,10,1,1972,5
burne hogarth,Dynamic Anatomy,1990,4,9,1,1977,13
burne hogarth,Dynamic Wrinkles and Drapery,1995,5,0,1,1990,5
burne hogarth,Dynamic Figure Drawing,1996,6,9,1,1995,1
burton g. malkiel,A Random Walk Down Wall Street Seventh Edition,2000,2,10,1,1996,4
burton g. malkiel,The Random Walk Guide to Investing: Ten Rules for Financial Success,2003,3,0,1,2000,3
burton kaplan,Everything You Need to Know to Talk Your Way to Success,1994,2,0,2,1991,3
burton raffel,Signet Classic Book of Contemporary Short Stories,1986,2,0,3,1984,2
burton raffel,Signet Classic Book of American Short Stories,1990,3,2.6666666666666665,3,1986,4
burton raffel,Beowulf,1995,4,4.333333333333333,9,1990,5
burton raffel,Beowulf (Signet Classics (Paperback)),1999,5,2.7142857142857144,7,1995,4
burton raffel,Sir Gawain and the Green Knight (Signet Classics (Paperback)),2001,6,5.666666666666667,3,1999,2
burton raffel,The Red and the Black (Modern Library),2003,7,6,1,2001,2
c j songer,Hook : A Meg Gillis Crime Novel (Meg Gillis Crime Novel),2001,2,7,1,1999,2
c. david heymann,POOR LITL RICH GRL,1986,2,0,3,1983,3
c. david heymann,A Woman Named Jackie,1991,3,1.6363636363636365,11,1986,5
c. david heymann,A Woman Named Jackie,1991,4,0,4,1991,0
c. david heymann,A Woman Named Jackie: An Intimate Biography of Jacqueline Bouvier Kennedy Onassis,1994,5,0,1,1991,3
c. david heymann,Liz: An Intimate Biography of Elizabeth Taylor,1995,6,8,1,1994,1
c. david heymann,RFK: A Candid Biography of Robert F. Kennedy,1998,7,7,1,1995,3
c. donald ahrens,"Essentials of Meteorology: An Invitation to the Atmosphere (with Blue Skies, College Edition CD-ROM)",2000,2,0,1,1994,6
c. s. evans,Sleeping Beauty (Everyman's Library Children's Classics),1993,2,10,1,1971,22
c. van amerongen (translator),How Things Work: The Universal Encyclopedia of Machines,1972,2,7,1,1967,5
c. warren hollister,Medieval Europe: A Short Source Book,1996,2,6,1,1994,2
c. warren hollister,Medieval Europe: A Short History,1997,3,8,1,1996,1
c.j. carmichael,"A CONVENIENT PROPOSAL - THE SHANNON SISTERS (Harlequin Superromance, No. 1044)",2002,2,2.6666666666666665,3,1999,3
c.j. carmichael,"A Lasting Proposal (The Shannon Sisters) (Harlequin Superromance, No. 1050)",2002,3,4,2,2002,0
c.j. carmichael,"Second - Chance Proposal (The Shannon Sisters) (Harlequin Superromance, No. 1038)",2002,4,2.5,6,2002,0
c.j. carmichael,The Legend,2002,5,0,2,2002,0
c.j. carmichael,together by christmas,2002,6,3.111111111111111,9,2002,0
c.j. carmichael,"Leaving Enchantment : The Birth Place (Harlequin Superromance, 1170)",2003,7,3,5,2002,1
c.j. carmichael,For A Baby (Harlequin Superromance),2004,8,3,2,2003,1
c.k. stead,Sister Hollywood,1994,2,0,1,1993,1
c.s. friedman,In Conquest Born,1991,2,0.75,4,1991,0
c.s. friedman,"When True Night Falls (Coldfire Trilogy, Book 2)",1994,3,3,6,1991,3
c.s. friedman,"Black Sun Rising (The Coldfire Trilogy, Book 1)",1994,4,2.0588235294117645,17,1994,0
c.s. friedman,"When True Night Falls (Coldfire Trilogy, Book 2)",1994,5,0,2,1994,0
c.s. lewis,Perelandra,1965,2,1.5,10,1965,0
c.s. lewis,"Lion, the Witch and the Wardrobe",1970,3,3.8333333333333335,66,1965,5
c.s. lewis,GREAT DIVORCE,1978,4,2.3636363636363638,11,1970,8
c.s. lewis,MIRACLES (Macmillan paperbacks edition),1978,5,0,2,1978,0
c.s. lewis,PROBLEM OF PAIN,1978,6,0,2,1978,0
c.s. lewis,WEIGHT OF GLORY AND OTHER ADDRESSES,1980,7,0,1,1978,2
c.s. lewis,SCREWTAPE LETTERS,1984,8,10,1,1980,4
c.s. lewis,First and Second Things: Essays on Theology and Ethics,1985,9,0,1,1984,1
c.s. lewis,MERE CHRISTIANITY,1986,10,4.4,5,1985,1
c.s. lewis,OUT OF THE SILENT PLANET,1987,11,2.0833333333333335,12,1986,1
c.s. lewis,Perelandra (Space Trilogy (Paperback)),1987,12,4,5,1987,0
c.s. lewis,That Hideous Strength (A Modern Fairy-Tale for Grownups),1987,13,3,5,1987,0
c.s. lewis,ESSENTIAL C.S. LEWIS,1988,14,10,1,1987,1
c.s. lewis,All My Road Before Me: The Diary of C.S.Lewis 1922-27,1990,15,0,1,1988,2
c.s. lewis,"The Lion, the Witch, and the Wardrobe",1994,16,2.25,24,1990,4
c.s. lewis,OUT OF THE SILENT PLANET,1996,17,2.5,10,1994,2
c.s. lewis,JOYFUL CHRISTIAN,1996,18,3,6,1996,0
c.s. lewis,Perelandra (Scribner Classics),1996,19,4.5,2,1996,0
c.s. lewis,That Hideous Strength (Scribner Classics),1996,20,0,1,1996,0
c.s. lewis,THAT HIDEOUS STRENGTH,1996,21,2.7,10,1996,0
c.s. lewis,SCREWTAPE LETTERS,1996,22,2.8181818181818183,11,1996,0
c.s. lewis,Out of the Silent Planet (Scribner Classics),1996,23,9,1,1996,0
c.s. lewis,PERELANDRA,1996,24,4.222222222222222,9,1996,0
c.s. lewis,Perelandra (Space Trilogy (Paperback)),2003,25,7,1,1996,7
c.s. lewis,Out of the Silent Planet (Space Trilogy (Paperback)),2003,26,1.1428571428571428,7,2003,0
c.s. lewis,That Hideous Strength (Space Trilogy (Paperback)),2003,27,0,1,2003,0
cally hall,DK Handbooks: Gemstones,1994,2,10,1,1993,1
cameron judd,The Canebrake Men: A Novel of the Tennessee Frontier: 1785-1800,1993,2,7,1,1989,4
cameron judd,Brazos,1994,3,0,1,1993,1
cameron judd,Boone: A Novel Based on the Life and Times of Daniel Boone,1995,4,10,1,1994,1
cameron judd,Passage to Natchez,1996,5,0,1,1995,1
cameron judd,"Season of Reckoning: A Novel of Unionist Resistance in Tennessee and North Carolina, January 1864-February 1866 (Judd, Cameron. Mountain War Trilogy, Bk. 3.)",1997,6,0,1,1996,1
cameron judd,"The Shadow Warriors: A Novel of Unionist Resistance in Tennessee and North Carolina, September 1860-January 1863 (Mountain War, No 1)",1997,7,0,2,1997,0
cameron judd,Texas Freedom (Underhill Series),1998,8,0,2,1997,1
cameron judd,The Glory River (Underhill),1998,9,0,1,1998,0
cameron judd,"Dead Man's Gold (Judd, Cameron. Underhill Series.)",1999,10,0,1,1998,1
cameron judd,Devil Wire,1999,11,0,1,1999,0
cameron judd,Brazos,2000,12,0,1,1999,1
cameron judd,Firefall,2000,13,7,1,2000,0
camika spencer,When All Hell Breaks Loose,2000,2,0,1,1999,1
camika spencer,Cubicles : A Novel,2002,3,9,1,2000,2
camille minichino,The Beryllium Murder (Gloria Lamerino Mysteries (Hardcover)),2000,2,0,1,1999,1
camille minichino,Lithium Murder (Worldwide Mystery),2001,3,1.75,8,2000,1
camille minichino,Beryllium Murder (Worldwide Library Mysteries),2001,4,0,3,2001,0
camille minichino,The Boric Acid Murder : A Gloria Lamerino Mystery (Gloria Lamerino Mysteries (Hardcover)),2002,5,3.4,5,2001,1
camille minichino,The Hydrogen Murder: A Gloria Lamerino Mystery,2003,6,0,4,2002,1
camille minichino,The Boric Acid Murder (WWL Mystery),2004,7,0,1,2003,1
camille minichino,The Helium Murder (Worldwide Library Mysteries),2004,8,2,2,2004,0
camille minichino,The Carbon Murder : A Periodic Table Mystery (Gloria Lamerino Mysteries (Hardcover)),2004,9,3,3,2004,0
camilo josã© cela,Viaje al Pirineo de LÃ©rida (Libros de bolsillo Noguer ; 20),1974,2,0,1,1973,1
camilo josã© cela,Oficio de tinieblas 5 (Libros DB),1979,3,0,1,1974,5
camilo josã© cela,Gavilla de fÃ¡bulas sin amor (Libro amigo ; 1502/636),1979,4,0,1,1979,0
camilo josã© cela,Los vasos comunicantes (Narradores de hoy),1981,5,0,1,1979,2
camilo josã© cela,Nuevo viaje a la Alcarria (Plaza &amp; JanÃ©s literaria),1986,6,0,3,1981,5
camilo josã© cela,Nuevas escenas matritenses (Literaria),1988,7,0,1,1986,2
camilo josã© cela,Desde el palomar de Hita (Plaza &amp; JanÃ©s/literaria),1991,8,0,1,1988,3
camilo josã© cela,Nuevo retablo de don Cristobita,2000,9,0,1,1991,9
campbell,Broken Promises,1982,2,0,3,1978,4
campbell,Barra's Angel,1999,3,0,1,1982,17
candas jane dorsey,Black Wine,1998,2,5,1,1997,1
candas jane dorsey,A Paradigm of Earth,2001,3,4.666666666666667,3,1998,3
candas jane dorsey,Vanilla and Other Stories,2001,4,0,2,2001,0
candice adams,When Opposites Attract,1984,2,0,2,1982,2
candice adams,Finders Keepers (Supreme #60),1985,3,0,1,1984,1
carl heintze,Summit Lake,1976,2,0,1,1975,1
carl waldman,Atlas of the North American Indian,1995,2,10,1,1995,0
carl waldman,Word Dance: The Language of Native American Culture,1996,3,10,1,1995,1
carl waldman,The Art of Magic: The Companion to the Pbs Special,1998,4,0,3,1996,2
carl waldman,Atlas of the North American Indian,2000,5,7,1,1998,2
carlene thompson,Black for Remembrance,1992,2,3.6666666666666665,6,1991,1
carlene thompson,All Fall Down,1993,3,8,1,1992,1
carlene thompson,The Way You Look Tonight (Way You Look Tonight),1997,4,2.3333333333333335,6,1993,4
carlene thompson,Tonight You're Mine,1998,5,2,7,1997,1
carlene thompson,In the Event of My Death,1999,6,4,8,1998,1
carlene thompson,In the Event of My Death,1999,7,4,2,1999,0
carlene thompson,Don't Close Your Eyes,2000,8,2.5555555555555554,9,1999,1
carlene thompson,Don't Close Your Eyes,2000,9,7,1,2000,0
carlene thompson,Im Falle meines Todes.,2001,10,0,1,2000,1
carlene thompson,Since You've Been Gone,2001,11,4.222222222222222,9,2001,0
carlene thompson,Black for Remembrance,2002,12,1.1875,16,2001,1
carlene thompson,"Vergiss, wenn du kannst.",2002,13,4.666666666666667,3,2002,0
carlene thompson,If She Should Die,2003,14,4.230769230769231,13,2002,1
carlo gebler,Malachy and His Family,1991,2,0,1,1990,1
carlo gebler,W9 &amp; Other Lives,1998,3,0,2,1991,7
carlo gebler,How to Murder a Man,1999,4,3.5,2,1998,1
carlo gebler,Caught on a Train,2004,5,0,1,1999,5
carlos castaneda,A separate reality : further conversations with Don Juan,1972,2,3.25,4,1971,1
carlos castaneda,JOURNEY IXTLAN,1972,3,3.5,2,1972,0
carlos castaneda,SEPARATE REALITY P,1972,4,0,4,1972,0
carlos castaneda,TEACHINGS DON JUAN,1973,5,0,1,1972,1
carlos castaneda,JOURNEY IXTLAN   P,1973,6,0,1,1973,0
carlos castaneda,Teachings of Don Juan,1974,7,2.5,2,1973,1
carlos castaneda,TALES OF POWER,1974,8,3.6,5,1974,0
carlos castaneda,JOURNEY IXTLAN,1975,9,0,1,1974,1
carlos castaneda,TALES OF POWER   P,1975,10,5,1,1975,0
carlos castaneda,A Separate Reality,1976,11,0,1,1975,1
carlos castaneda,TALES OF POWER,1976,12,4.5,2,1976,0
carlos castaneda,L'Herbe du diable et la petite fumÃ?Â©e,1977,13,0,1,1976,1
carlos castaneda,2ND RING OF POWER (Fireside Books (Holiday House)),1978,14,3.8,5,1977,1
carlos castaneda,2ND RING OF POWR P (A Touchstone Book),1979,15,0,1,1978,1
carlos castaneda,Der zweite Ring der Kraft.,1980,16,0.3333333333333333,3,1979,1
carlos castaneda,2ND RING OF POWR,1980,17,7.5,2,1980,0
carlos castaneda,EAGLES GIFT,1981,18,3.8,5,1980,1
carlos castaneda,Tales of Power,1981,19,2.3333333333333335,3,1981,0
carlos castaneda,Tales of Power,1981,20,0,3,1981,0
carlos castaneda,Separate Reality,1982,21,8,1,1981,1
carlos castaneda,Eagles Gift,1982,22,9,1,1982,0
carlos castaneda,Separate Reality,1982,23,0,2,1982,0
carlos castaneda,Second Ring of Power,1982,24,1.25,4,1982,0
carlos castaneda,EAGLES GIFT,1982,25,1.75,8,1982,0
carlos castaneda,FIRE FROM WITHIN,1984,26,0,3,1982,2
carlos castaneda,FIRE FROM WITHIN,1985,27,3.375,8,1984,1
carlos castaneda,Voir - Les Enseignements d'un sorcier yaqui,1985,28,0,1,1985,0
carlos castaneda,The Teachings of Don Juan: A Yaqui Way of Knowledge,1985,29,4.875,8,1985,0
carlos castaneda,JOURNEY IXTLAN,1985,30,5.666666666666667,3,1985,0
carlos castaneda,FIRE FROM WITHIN,1986,31,0,1,1985,1
carlos castaneda,The Power of Silence,1988,32,2.3333333333333335,3,1986,2
carlos castaneda,TEACHINGS OF DON JUAN : TEACHINGS OF DON JUAN,1990,33,2.2857142857142856,7,1988,2
carlos castaneda,Separate Reality,1991,34,2.9,10,1990,1
carlos castaneda,Eagle's Gift,1991,35,5.333333333333333,3,1991,0
carlos castaneda,Power of Silence,1991,36,0,1,1991,0
carlos castaneda,Tales of Power,1991,37,5.6,5,1991,0
carlos castaneda,Journey To Ixtlan,1991,38,6,3,1991,0
carlos castaneda,The Power of Silence: Further Lessons of Don Juan,1991,39,3.6666666666666665,6,1991,0
carlos castaneda,The Art of Dreaming,1993,40,0,1,1991,2
carlos castaneda,The Art of Dreaming,1994,41,3,5,1993,1
carlos castaneda,Die Kunst des TrÃ?Â¤umens.,1998,42,8,1,1994,4
carlos castaneda,Reise nach Ixtlan. Die Lehre des Don Juan.,1998,43,1.1428571428571428,7,1998,0
carlos castaneda,The Teachings of Don Juan: A Yaqui Way of Knowledge,1998,44,3.3333333333333335,3,1998,0
carlos castaneda,Der Ring der Kraft. Don Juan in den StÃ?Â¤dten.,1998,45,1.6,5,1998,0
carlos castaneda,Die Lehren des Don Juan. Ein Yaqui- Weg des Wissens.,1998,46,1.4,10,1998,0
carlos castaneda,The TEACHINGS OF DON JUAN A YAQUI WAY OF KNOWLEDGE,1998,47,5,1,1998,0
carlos castaneda,The Teachings of Don Juan: A Yaqui Way of Knowledge,1998,48,10,1,1998,0
carlos castaneda,Eine andere Wirklichkeit. Neue GesprÃ?Â¤che mit Don Juan.,1998,49,0,5,1998,0
carlos castaneda,La rueda del tiempo,1999,50,0,1,1998,1
carlos castaneda,The Active Side of Infinity,1999,51,0,1,1999,0
carlos castaneda,The Active Side of Infinity,2000,52,0,1,1999,1
carlos castaneda,Das Rad der Zeit. Das VermÃ?Â¤chtnis des Don Juan.,2001,53,0,1,2000,1
carlos castaneda,The Wheel Of Time : The Shamans Of Mexico Their Thoughts About Life Death And The Universe,2001,54,4.333333333333333,3,2001,0
carlos e asay,The seven M's of missionary service,1996,2,0,1,1990,6
carly bishop,Reckless Lover (Harlequin For Her Eyes Only),1996,2,0,1,1990,6
carly bishop,"No One But You (Lovers Under Cover) (Harlequin Intrigue, No 616)",2001,3,1.25,8,1996,5
carman,R I O T Manual,1999,2,3.3333333333333335,3,1994,5
carman,The Champion: The Story That Inspired the Full-Length Motion Picture,2001,3,0,4,1999,2
carmen adams,The Claw,1995,2,2,6,1994,1
carmen adams,Song of the Vampire (An Avon Flare Book),1996,3,0,1,1995,1
carmen bredeson,Living on a Space Shuttle (Rookie Read-About Science),2003,2,0,1,2003,0
carmen green,"Doctor, Doctor (Arabesque)",2002,2,0,1,2001,1
carmen kurtz,Veva/Veva,1998,2,7,3,1984,14
carmen vazquez-vigo,El Muneco De Don Bepo (Barco de Vapor),1984,2,0,1,1984,0
carol ann rinzler,Nutrition for Dummies,1997,2,8,1,1996,1
carol ann rinzler,Nutrition for Dummies,1999,3,4,2,1997,2
carol barkin,The Complete Babysitter's Handbook,1981,2,0,1,1977,4
carol barkin,The New Complete Babysitter's Handbook,1995,3,0,1,1981,14
carol barkin,When Your Kid Goes to College; A Parent's Survival Guide,1999,4,0,2,1995,4
carol bolt,Das Buch der Antworten.,2000,2,7,2,1999,1
carol bolt,The Literary Book of Answers,2000,3,1,3,2000,0
carol bolt,Love's Book of Answers,2002,4,0,2,2000,2
carol card otten,Pieces of Yesterday (Quilting Romance),1999,2,0,4,1996,3
carol clewlow,Love in the modern sense,1992,2,4,2,1989,3
carol cummings,Winning Strategies for Classroom Management,2000,2,10,1,1980,20
carol devine,"Man Of The Land (Silhouette Desire, No 909)",1995,2,1.6666666666666667,3,1993,2
carol devine,"Marriage For Sale (The Bridal Bid) (Desire, 1284)",2000,3,10,1,1995,5
carol iverson,There Are Golf Balls on the Moon: And Other Facts and Curiosities (I Bet You Didn't Know That),1991,2,0,1,1990,1
carol jerina,"LADY RAINE (Tapestry Romance, No. 39)",1984,2,3.5,2,1984,0
carol jerina,FLIRTING WITH DISASTER,1990,3,5,1,1984,6
carol jerina,A Golden Dream,1991,4,0,1,1990,1
carol jerina,The Bridegroom (Harper Monogram),1993,5,4.5,2,1991,2
carol jerina,Golden Dream,1994,6,0,1,1993,1
carol kent,Becoming a Woman of Influence: Making a Lasting Impact on Others,1999,2,0,2,1996,3
carol kuykendall,Give Them Wings,1998,2,0,4,1996,2
carol lea benjamin,Dash P. I.,1997,2,0,1,1985,12
carol lea benjamin,The Dog Who Knew Too Much: A Rachel Alexander and Dash Mystery (Rachel Alexander &amp; Dash Mysteries (Paperback)),1998,3,0,3,1997,1
carol lea benjamin,This Dog for Hire: A Rachel Alexander and Dash Mystery (Rachel Alexander &amp; Dash Mysteries (Paperback)),1998,4,1.5714285714285714,7,1998,0
carol lea benjamin,A Hell of a Dog (Rachel Alexander &amp; Dash Mysteries (Paperback)),1999,5,3,2,1998,1
carol lea benjamin,Lady Vanishes: A Rachel Alexander and Dash Mystery (Rachel Alexander &amp; Dash Mysteries (Hardcover)),1999,6,0,1,1999,0
carol lea benjamin,The Wrong Dog: A Rachel Alexander and Dash Mystery (Rachel Alexander &amp; Dash Mysteries (Hardcover)),2000,7,2.6666666666666665,3,1999,1
carol lea benjamin,Fall Guy : A Rachel Alexander Mystery,2004,8,9,1,2000,4
carol matthau,Among the Porcupines: A Memoir,1993,2,0,1,1992,1
carol oconnell,Mallorys Orakel. Sonderausgabe.,2000,2,0,1,2000,0
carol oconnell,Der steinerne Engel.,2002,3,7,1,2000,2
carol oconnell,Falscher Zauber.,2003,4,5,1,2002,1
carol poh miller,"Cleveland: A Concise History, 1796-1990 (The Encyclopedia of Cleveland History, 1)",1997,2,7,1,1990,7
carol watson,Animal Legends (Usborne Story Books),1982,2,0,1,1980,2
carol watson,My First Encyclopedia,2001,3,8,1,1982,19
carole clements,"Simply French: Light, Fresh and Healthy Dishes from a Classic Cuisine",1996,2,0,1,1996,0
carole clements,Cook's Companion (The Ultimate Cooking Course and Kitchen Encyclopedia),2001,3,0,1,1996,5
carole kruppa,The love your heart (low cholesterol) cookbook,1990,2,5,1,1985,5
carole kruppa,The Free &amp; Equal Dessert Cookbook,1992,3,0,1,1990,2
carole l. glickfeld,Swimming Toward the Ocean,2002,2,4.5,2,2001,1
carole matthews,Bare Necessity,2003,2,0,4,2002,1
carole matthews,Bare Necessity,2003,3,2.8518518518518516,27,2003,0
carole matthews,"For Better, for Worse",2003,4,4,4,2003,0
carole matthews,In guten wie in schlechten Tagen.,2003,5,5,1,2003,0
carole matthews,The Sweetest Taboo,2004,6,2,7,2003,1
carole matthews,Let's Meet On Platform 8 (Red Dress Ink),2004,7,1.9,10,2004,0
carole mayhall,"Here I Am Again, Lord: Confessions of a Slow Learner",1999,2,0,1,1976,23
carole n. douglas,"Cup of Clay (Taliswoman, Bk 1)",1994,2,0,7,1986,8
carole nelson douglas,Six of Swords,1984,2,0,2,1982,2
carole nelson douglas,"Seven of Swords (Swords and Circlet, No 3)",1989,3,0,1,1984,5
carole nelson douglas,"Good Night, Mr. Holmes (Irene Adler)",1991,4,1.7647058823529411,17,1989,2
carole nelson douglas,"Good Morning, Irene (Irene Adler)",1992,5,0.6363636363636364,11,1991,1
carole nelson douglas,Six of Swords,1992,6,2,3,1992,0
carole nelson douglas,Catnap : A Midnight Louie Mystery (A Midnight Louie Mystery),1993,7,2,24,1992,1
carole nelson douglas,Lady Rogue,1993,8,0,1,1993,0
carole nelson douglas,Pussyfoot: A Midnight Louis Mystery,1993,9,0,2,1993,0
carole nelson douglas,Irene At Large (Irene Adler),1993,10,0,7,1993,0
carole nelson douglas,Irene's Last Waltz,1994,11,0,5,1993,1
carole nelson douglas,"Seed upon the Wind (Tallis Women, No 2)",1994,12,0,1,1994,0
carole nelson douglas,Pussyfoot : A Midnight Louie Mystery (A Midnight Louie Mystery),1994,13,1.5714285714285714,14,1994,0
carole nelson douglas,Cat on a Blue Monday : A Midnight Louie Mystery (A Midnight Louie Mystery),1994,14,1.0833333333333333,12,1994,0
carole nelson douglas,Cat in a Crimson Haze: A Midnight Louie Mystery,1995,15,4,1,1994,1
carole nelson douglas,Cat in a Diamond Dazzle: A Midnight Louie Mystery,1996,16,0,1,1995,1
carole nelson douglas,Cat in a Crimson Haze : A Midnight Louie Mystery (A Midnight Louie Mystery),1996,17,0.9,10,1996,0
carole nelson douglas,Cat with an Emerald Eye : A Midnight Louie Mystery (A Midnight Louie Mystery),1997,18,1.5454545454545454,11,1996,1
carole nelson douglas,Cat in a Golden Garland: A Midnight Louie Mystery (Midnight Louie Mysteries (Hardcover)),1997,19,0,1,1997,0
carole nelson douglas,Cat in a Diamond Dazzle : A Midnight Louie Mystery (A Midnight Louie Mystery),1997,20,0.8333333333333334,6,1997,0
carole nelson douglas,Cat in a Golden Garland : A Midnight Louie Mystery (A Midnight Louie Mystery),1998,21,3.2857142857142856,7,1997,1
carole nelson douglas,Midnight Louie's Pet Detectives,1998,22,3.5,2,1998,0
carole nelson douglas,Cat on a Hyacinth Hunt: A Midnight Louie Mystery (Midnight Louie Mysteries/Carole Nelson Douglas),1998,23,4,6,1998,0
carole nelson douglas,Cat in a Flamingo Fedora : A Midnight Louie Mystery (A Midnight Louie Mystery),1998,24,2.142857142857143,7,1998,0
carole nelson douglas,Cat on a Hyacinth Hunt,1999,25,3.5,2,1998,1
carole nelson douglas,Cat in an Indigo Mood : A Midnight Louie Mystery (A Midnight Louie Mystery),1999,26,0,4,1999,0
carole nelson douglas,Cat in an Indigo Mood: A Midnight Louie Mystery,1999,27,0,2,1999,0
carole nelson douglas,"Cat in a Jeweled Jumpsuit: A Midnight Louie Mystery (Douglas, Carole Nelson. Midnight Louie Mysteries.)",1999,28,0,1,1999,0
carole nelson douglas,Cat on a Hyacinth Hunt : A Midnight Louie Mystery (A Midnight Louie Mystery),1999,29,0.75,8,1999,0
carole nelson douglas,Midnight Louie's Pet Detectives,2000,30,1.5789473684210527,19,1999,1
carole nelson douglas,Cat in a Kiwi Con: A Midnight Louie Mystery,2000,31,0,4,2000,0
carole nelson douglas,Cat in a Jeweled Jumpsuit : A Midnight Louie Mystery (A Midnight Louie Mystery),2000,32,1.8,5,2000,0
carole nelson douglas,"Chapel Noir: A Novel of Suspense featuring Sherlock Holmes, Irene Adler, and Jack the Ripper",2001,33,3,3,2000,1
carole nelson douglas,Cat in a Leopard Spot: A Midnight Louie Mystery (Midnight Louie Mysteries (Hardcover)),2001,34,0.8,5,2001,0
carole nelson douglas,Cat in a Kiwi Con : A Midnight Louie Mystery (A Midnight Louie Mystery),2001,35,2.142857142857143,7,2001,0
carole nelson douglas,"Chapel Noir: A Novel of Suspense featuring Sherlock Holmes, Irene Adler, and Jack the Ripper",2002,36,2.3333333333333335,9,2001,1
carole nelson douglas,Cat in a Leopard Spot : A Midnight Louie Mystery (A Midnight Louie Mystery),2002,37,2.9,10,2002,0
carole nelson douglas,Cat in a Midnight Choir: A Midnight Louie Mystery,2002,38,9,1,2002,0
carole nelson douglas,"Castle Rouge: A Novel of Suspense featuring Sherlock Holmes, Irene Adler, and Jack the Ripper",2002,39,8,3,2002,0
carole nelson douglas,Cat in a Midnight Choir : A Midnight Louie Mystery (A Midnight Louie Mystery),2003,40,2.272727272727273,11,2002,1
carole nelson douglas,Castle Rouge (Irene Adler),2003,41,1.5,6,2003,0
carole nelson douglas,Cat in a Neon Nightmare: A Midnight Louie Mystery,2003,42,9,1,2003,0
carole nelson douglas,The Adventuress (Irene Adler),2003,43,0,2,2003,0
carole nelson douglas,Another Scandal in Bohemia: A Novel of Suspense Featuring Sherlock Holmes and Irene Adler,2003,44,0,3,2003,0
carole nelson douglas,Femme Fatale : An Irene Adler Novel (Irene Adler),2003,45,10,1,2003,0
carole nelson douglas,Cat in a Neon Nightmare (A Midnight Louie Mystery),2004,46,0,1,2003,1
carole nelson douglas,Cat in an Orange Twist (A Midnight Louie Mystery),2004,47,10,1,2004,0
carole smith,Magic Castle,1999,2,6.5,2,1998,1
carole tonkinson,Wake Up and Cook: Kitchen Buddhism in Words and Recipes,1997,2,5,2,1995,2
carole waterhouse,The Paradise Ranch,2003,2,1.1666666666666667,6,2001,2
carolee brockmann,Going for Great (Ag Fiction (American Girl)),1999,2,3,3,1999,0
caroline anderson,"Practically Perfect (Harlequin Medical Romance, #1)",1999,2,0,1,1999,0
caroline anderson,Sarah's Gift (Harlequin Prescription Romance),1999,3,0,1,1999,0
caroline anderson,"A Mother by Nature (Medical Romance, #3)",2000,4,4.5,2,1999,1
caroline anderson,Delivered: One Family (Ready For Baby) (Harlequin Romance),2001,5,0,2,2000,1
caroline anderson,"Impetuous Bride : Nearlyweds (Romance, 3676)",2001,6,0,2,2001,0
caroline anderson,Rescuing Dr. Ryan (Harlequin Medical Romance),2001,7,0,1,2001,0
caroline anderson,Assignment:  Single Man  (Double Destiny),2002,8,0,1,2001,1
caroline anderson,A Very Single Woman (Medical Romance),2002,9,0,1,2002,0
caroline anderson,Assignment: Single Father  (Double Destiny),2003,10,0,3,2002,1
caroline anderson,Chemical Reaction   Heartbeat (Reader's Choice),2003,11,0,2,2003,0
caroline anderson,With This Baby   (What Women Want),2003,12,0,1,2003,0
caroline anderson,The Pregnant Tycoon : Ready for Baby (Romance),2004,13,0,1,2003,1
caroline carver,Blood Junction,2003,2,0,3,2002,1
caroline carver,Dead Heat,2004,3,5,1,2003,1
caroline moorehead,Gellhorn: A Twentieth Century Life,2003,2,4,4,1997,6
caroline slate,The House on Sprucewood Lane,2003,2,1.3333333333333333,6,2002,1
caroline slate,A Fractured Truth : A Novel,2003,3,7,2,2003,0
caroline young,Great Wildlife Search (Great Searches),1998,2,10,1,1997,1
carolyn reeder,Shades of Gray (Avon Camelot Books (Paperback)),1992,2,4,4,1991,1
carolyn reeder,Grandpa's Mountain,1993,3,3,5,1992,1
carolyn reeder,Moonshiner's Son,1995,4,0,3,1993,2
carolyn reeder,Shades of Gray,1999,5,0,1,1995,4
carolyn reeder,Captain Kate,2000,6,0,1,1999,1
carolyn reeder,Foster's War,2001,7,9,2,2000,1
carolyn reeder,Before the Creeks Ran Red,2003,8,0,1,2001,2
carrie randall,"The Party (Dear Diary, No 1)",1989,2,0,1,1989,0
carrie randall,"The Mystery (Dear Diary, No 4)",1991,3,5,1,1989,2
carter,Scandal of Falconhurs,1980,2,0,1,1976,4
cary fagan,"The doctor's house, and other fiction",2000,2,0,1,1999,1
cary fagan,The Mermaid of Paris,2003,3,0,1,2000,3
casey douglas,"Season Of Enchantmen (Harlequin Superromance, No 271)",1987,2,9,1,1983,4
casey loe,Versus Books Official Neverwinter Nights Adventure Perfect Guide,2002,2,9,1,2001,1
casey roberts,Shenanigans (Harlequin Superromance No. 70547),1993,2,0,1,1990,3
casey stuart,Midnight Thunder,1986,2,3.5,2,1985,1
casey stuart,Beloved Pirate,1988,3,0,1,1986,2
casey stuart,Highland Rogue,1991,4,0,2,1988,3
catharine a. mackinnon,Toward a Feminist Theory of the State,1991,2,3,1,1988,3
catherine anderson,"Switchback (Intrigue, No 135)",1990,2,0,1,1988,2
catherine anderson,Comanche Moon,1991,3,0,2,1990,1
catherine anderson,Comanche Heart,1991,4,0,1,1991,0
catherine anderson,Indigo Blue (Harper Monogram),1992,5,2.3333333333333335,3,1991,1
catherine anderson,"Cry Of The Wild (Harlequin Intrigue, No 206)",1992,6,2,4,1992,0
catherine anderson,Comanche Moon,1993,7,0,2,1992,1
catherine anderson,Coming up Roses (Harper Monograms),1993,8,0,3,1993,0
catherine anderson,Cheyenne Amber : Cheyenne Amber (Harper Monogram),1994,9,0,2,1993,1
catherine anderson,Annie's Song,1996,10,4.111111111111111,18,1994,2
catherine anderson,Keegan's Lady,1996,11,9,1,1996,0
catherine anderson,Simply Love,1997,12,1.1818181818181819,11,1996,1
catherine anderson,Cherish,1998,13,3.4,10,1997,1
catherine anderson,Forever After,1998,14,1,10,1998,0
catherine anderson,Baby Love,1999,15,2.888888888888889,18,1998,1
catherine anderson,Seventh Heaven,2000,16,1.2222222222222223,18,1999,1
catherine anderson,Phantom Waltz,2001,17,3.75,16,2000,1
catherine anderson,Sweet Nothings,2002,18,2,27,2001,1
catherine anderson,Always in My Heart,2002,19,2.3636363636363638,22,2002,0
catherine anderson,Always in My Heart (Wheeler Large Print Softcover Series),2002,20,0,1,2002,0
catherine anderson,Only by Your Touch (Signet Books),2003,21,3,38,2002,1
catherine anderson,Blue Skies,2004,22,2.4545454545454546,33,2003,1
catherine anderson,Bright Eyes (Coulter Family Series),2004,23,4.833333333333333,12,2004,0
catherine clement,Opera: The Undoing of Women,1999,2,6,1,1998,1
catherine clement,Theo's Odyssey,1999,3,5.333333333333333,3,1999,0
catherine clement,Theos Reise. Roman Ã?Â¼ber die Religionen der Welt.,2000,4,4.5,12,1999,1
catherine clement,Martin and Hannah: A Novel,2001,5,0,1,2000,1
catherine dee,"The Girls' Book of Success: Winning Wisdom, Stars' Secrets, Tales of Triumph, and More",2003,2,7,1,2002,1
catherine hermary-vieille,La piste des turquoises,1992,2,6,1,1990,2
catherine hermary-vieille,La piste des turquoises,1994,3,3,1,1992,2
catherine leigh,"Something Old, Something New  (Hitched) (Harlequin Romance, No 3426)",1996,2,3,2,1990,6
catherine leigh,"Rebel Without A Bride (Harlequin Romance, No 3469)",1997,3,0,1,1996,1
catherine leigh,"One Night Before Christmas (Harlequin Romance, 3533)",1998,4,0,3,1997,1
catherine lyndell,"ALLIANCE OF LOVE (Tapestry Romance, No. 31)",1984,2,7,1,1984,0
catherine lyndell,"CAPTIVE HEARTS (Tapestry, No 58)",1985,3,3.5,2,1984,1
catherine lyndell,TAPESTRY OF PRIDE,1987,4,0,1,1985,2
catherine lyndell,ARIANE,1987,5,10,1,1987,0
catherine lyndell,STOLEN DREAMS,1989,6,0,1,1987,2
catherine lyndell,JOURNEY TO DESIRE,1991,7,0,2,1989,2
catherine mann,Capitol Hill,1992,2,0,1,1989,3
catherine mann,Wedding at White Sands,2002,3,2,4,1992,10
catherine mann,Taking Cover  (wingmen warriors),2002,4,0,4,2002,0
catherine mann,"Grayson's Surrender  (Wingman Warriors) (Silhouette Intimate Moments, No. 1175)",2002,5,0.16666666666666666,6,2002,0
catherine mann,Private Maneuvers  (Wingman Warriors),2003,6,2.2,10,2002,1
catherine mann,"Anything, Anywhere, Anytime",2003,7,2.4285714285714284,7,2003,0
catherine mann,Under Siege  (Wingmen Warriors),2003,8,0,4,2003,0
catherine mann,Strategic Engagement : Wingmen Warriors (Silhouette Intimate Moments),2003,9,9,1,2003,0
catherine mann,The Cinderella Mission  (Family Secrets),2003,10,1.25,8,2003,0
catherine mann,Joint Forces (Silhouette Intimate Moments),2004,11,1.6666666666666667,3,2003,1
catherine palmer,Outlaw Heart,1992,2,3.5,2,1992,0
catherine palmer,"For The Love Of A Child (Silhouette Intimate Moments, No 7551)",1994,3,0,1,1992,2
catherine palmer,Falcon Moon,1994,4,0,2,1994,0
catherine palmer,"His Best Friend'S Wife (Silhouette Intimate Moments, No 627)",1995,5,0,1,1994,1
catherine palmer,"The Treasure of Zanzibar (Heartquest Series/Palmer, 2)",1997,6,5,1,1995,2
catherine palmer,Lone Star (HeartQuest),1998,7,0,1,1997,1
catherine palmer,Prairie Fire: A Town Called Hope #2 (Heartquest),1998,8,0,1,1998,0
catherine palmer,Finders Keepers (Finders Keepers #1),1999,9,0,2,1998,1
catherine palmer,A Victorian Christmas Cottage (HeartQuest Anthologies),1999,10,0,1,1999,0
catherine palmer,A Kiss of Adventure (Treasures of the Heart #1),2000,11,0,2,1999,1
catherine palmer,Hide and Seek (Finders Keepers #2),2001,12,5,2,2000,1
catherine palmer,The Happy Room,2002,13,9,2,2001,1
catherine palmer,A Victorian Rose,2002,14,2,2,2002,0
catherine palmer,English Ivy (Heartquest),2002,15,0,1,2002,0
catherine palmer,Fatal Harvest,2003,16,4.5,2,2002,1
catherine palmer,The Happy Room,2003,17,4.5,2,2003,0
catherine palmer,Fatal Harvest,2003,18,0,3,2003,0
catherine palmer,Sunrise Song (Heartquest),2003,19,4.5,2,2003,0
catherine palmer,Wild Heather (Heartquest),2004,20,10,1,2003,1
catherine robinson,Celia,2002,2,7,1,1990,12
catherine sefton,Horace the Ghost (Gazelle Books),1991,2,0,1,1986,5
catherine snodgrass,Silk Dreams and Satin Lies,2002,2,0,1,2001,1
catherine snodgrass,"Another Chance, Another Time",2002,3,5.333333333333333,3,2002,0
catherine snodgrass,Hurago,2002,4,0,1,2002,0
catherine snodgrass,Circle In The Sand,2003,5,0,1,2002,1
catherine todd,Making Waves,1997,2,1.4,5,1997,0
catherine todd,Exit Strategies: A Novel,2002,3,9,1,1997,5
catherine todd,Exit Strategies,2002,4,5.5,4,2002,0
catherine todd,Secret Lives of Second Wives,2003,5,9,1,2002,1
catherine todd,Secret Lives of Second Wives,2004,6,7,1,2003,1
cathleen galitz,"Cowboy Takes A Bride (The Bridal Bid) (Silhouette Desire, 1271)",2000,2,0,2,1997,3
cathleen galitz,"Wyoming Cinderella (Silhouette Desire, No 1373)",2001,3,0,6,2000,1
cathleen galitz,"Tall, Dark...and Framed? (Texas Cattleman's Club: The Last Bachelor) (Silhouette Desire, No. 1433)",2002,4,2.1666666666666665,6,2001,1
cathleen galitz,Warrior in Her Bed,2003,5,2.5,6,2002,1
cathleen galitz,"Pretending With The Playboy (Silhouette Desire, 1569)",2004,6,3,5,2003,1
cathleen galitz,Cowboy Crescendo : Dynasties: The Danforths (Desire),2004,7,3.5,2,2004,0
cathy marie hake,Mixed Blessings (Love Inspired),2004,2,0,1,2004,0
cathy maxwell,You and No Other,1996,2,3.75,4,1994,2
cathy maxwell,Falling in Love Again (Avon Romantic Treasure),1997,3,4.333333333333333,3,1996,1
cathy maxwell,When Dreams Come True,1998,4,1.1428571428571428,7,1997,1
cathy maxwell,Because of You (Avon Romantic Treasure),1999,5,1.3333333333333333,6,1998,1
cathy maxwell,Married in Haste,1999,6,3.125,16,1999,0
cathy maxwell,A Scandalous Marriage,2000,7,0,7,1999,1
cathy maxwell,The Marriage Contract,2001,8,1.9090909090909092,11,2000,1
cathy maxwell,The Wedding Wager,2001,9,2.5625,16,2001,0
cathy maxwell,The Lady Is Tempted,2002,10,3.526315789473684,19,2001,1
cathy maxwell,The Lady Is Tempted (Wheeler Large Print Hardcover Series),2002,11,7,1,2002,0
cathy maxwell,Tea for Two,2002,12,1.5,6,2002,0
cathy maxwell,Wild West Brides (3 Novels in 1),2002,13,1,5,2002,0
cathy maxwell,Adventures of a Scottish Heiress,2003,14,0,1,2002,1
cathy maxwell,The Seduction of an English Lady,2003,15,1.3333333333333333,6,2003,0
cathy maxwell,A Scandalous Marriage,2003,16,0,1,2003,0
cathy maxwell,Adventures of a Scottish Heiress,2003,17,4.375,16,2003,0
cathy maxwell,Temptation of a Proper Governess,2004,18,10,1,2003,1
catrin collier,Winners &amp; Losers,2004,2,0,1,2002,2
cecelia tishy,Jealous Heart,1999,2,0,3,1999,0
cecie starr,Biology: The Unity and Diversity of Life (Wadsworth Biology Series),1995,2,6,1,1993,2
cecilia dart-thornton,"The Lady of the Sorrows (The Bitterbynde, Book 2)",2002,2,8,1,2001,1
cecilia dart-thornton,"The Ill-Made Mute (The Bitterbynde, Book 1)",2002,3,2.3846153846153846,13,2002,0
cecilia dart-thornton,"The Lady of the Sorrows : The Bitterbynde Book II (The Bitterbynde, Book 2)",2003,4,3.25,8,2002,1
cecilia dart-thornton,"The Battle of Evernight (The Bitterbynde, Book 3)",2003,5,8,3,2003,0
cedco,The Fellowship of the Ring Journal (The Lord of the Rings),2001,2,9,1,2000,1
cedco,There and Back Again...: A Journal (The Lord of the Rings : the Fellowship of the Ring),2001,3,9,1,2001,0
celeste de blasis,Wild Swan,1984,2,4,2,1981,3
celeste de blasis,The Night Child,1986,3,3.5,4,1984,2
celeste de blasis,Swan's Chance,1986,4,2.6666666666666665,12,1986,0
celeste de blasis,"TIGER'S WOMAN, THE",1987,5,0,1,1986,1
celeste de blasis,Wild Swan (Wild Swan),1987,6,0.8333333333333334,6,1987,0
celeste de blasis,Suffer a Sea Change,1988,7,0,1,1987,1
celeste de blasis,Season of Swans,1990,8,1.5,6,1988,2
celia rees,Witch Child,2000,2,8.5,2,1997,3
celia rees,Truth or Dare,2000,3,0,3,2000,0
celia rees,Witch Child,2001,4,3.642857142857143,14,2000,1
celia rees,Hexenkind. ( Ab 12 J.).,2001,5,0,1,2001,0
celia rees,Witch Child,2002,6,5.409090909090909,22,2001,1
celia rees,Sorceress,2002,7,7,1,2002,0
celia rees,City of Shadows: Book 1  (The Celia Rees Supernatural Trilogy),2002,8,0,1,2002,0
celia rees,Blood Sinister (Point S.),2002,9,7,1,2002,0
celia rees,City of Shadows: Book 1  (The Celia Rees Supernatural Trilogy),2002,10,5,1,2002,0
celia rees,Hexenschwestern. ( Ab 12 J.).,2002,11,0,1,2002,0
celia rees,Sorceress,2003,12,2.5,2,2002,1
celia rees,Pirates!,2003,13,0,2,2003,0
celine dion,"Celine Dion : My Story, My Dream",2001,2,3,3,2000,1
cesare pavese,Le bel Ã?Â©tÃ?Â©,1978,2,0,2,1976,2
cesare pavese,Die SelbstmÃ?Â¶rder. ErzÃ?Â¤hlungen.,1987,3,7,1,1978,9
cesare pavese,Le bel Ã?Â©tÃ?Â©,1993,4,7,1,1987,6
cesare pavese,"Bello Verano, El",1996,5,0,1,1993,3
cesare pavese,Racconti,1998,6,0,1,1996,2
cesare pavese,The Moon and the Bonfires (New York Review Books Classics),2002,7,2.8,5,1998,4
cesare pavese,The Devil in the Hills (Peter Owen Modern Classic),2002,8,0,1,2002,0
cesare pavese,Der schÃ?Â¶ne Sommer.,2002,9,3.5,2,2002,0
cesare pavese,LA Luna E I Falo,2003,10,7,1,2002,1
cesare pavese,Terre d'exil et autres nouvelles,2003,11,0,2,2003,0
chaim potok,In the Beginning,1975,2,2.5714285714285716,7,1975,0
chaim potok,In the Beginning,1976,3,9,1,1975,1
chaim potok,Wanderings: Chaim Potok's History of the Jews,1980,4,0,2,1976,4
chaim potok,The Book of Lights,1981,5,0,3,1980,1
chaim potok,Wanderings History of the Jews,1982,6,10,1,1981,1
chaim potok,The Chosen,1982,7,2.7142857142857144,7,1982,0
chaim potok,The Chosen,1985,8,9.666666666666666,3,1982,3
chaim potok,Davita's Harp,1985,9,2,5,1985,0
chaim potok,The Promise,1985,10,3.6315789473684212,19,1985,0
chaim potok,In the Beginning,1989,11,5.333333333333333,9,1985,4
chaim potok,The Gift of Asher Lev: A Novel,1990,12,6,3,1989,1
chaim potok,Gift Asher Lev-Open Mkt,1990,13,5,2,1990,0
chaim potok,My Name Is Asher Lev,1990,14,5.166666666666667,18,1990,0
chaim potok,Wanderings: Chaim Potok's History of the Jews,1990,15,1.6,5,1990,0
chaim potok,Davita's Harp,1990,16,3.1923076923076925,26,1990,0
chaim potok,The Gift of Asher Lev,1991,17,4,4,1990,1
chaim potok,The Gift of Asher Lev,1991,18,5.2,5,1991,0
chaim potok,I Am the Clay,1992,19,4.5,2,1991,1
chaim potok,I Am the Clay,1994,20,2.5,8,1992,2
chaim potok,The Chosen,1995,21,3.296875,64,1994,1
chaim potok,My Name Is Asher Lev,1996,22,1.5384615384615385,13,1995,1
chaim potok,The Chosen (Ballantine Reader's Circle),1996,23,4.888888888888889,9,1996,0
chaim potok,The Gates of November: Chronicles of the Slepak Family,1996,24,0,1,1996,0
chaim potok,Davita's Harp,1996,25,0,3,1996,0
chaim potok,In the Beginning,1997,26,0,1,1996,1
chaim potok,The Promise,1997,27,7,1,1997,0
chaim potok,The Book of Lights,1997,28,2.7857142857142856,14,1997,0
chaim potok,The Book of Lights,1997,29,8,1,1997,0
chaim potok,I Am the Clay,1999,30,10,1,1997,2
chaim potok,Old Men at Midnight,2001,31,2.25,4,1999,2
chaim potok,Old Men at Midnight (Ballantine Reader's Circle),2002,32,3.5,4,2001,1
chaim potok,My Name Is Asher Lev,2003,33,2.2222222222222223,9,2002,1
chandler s. robbins,Birds of North America (Golden Field Guides),1983,2,7.125,8,1983,0
chang-rae lee,Native Speaker,1996,2,3.65,20,1995,1
chang-rae lee,A Gesture Life,1999,3,4.866666666666666,15,1996,3
chang-rae lee,A Gesture Life,2000,4,2.347826086956522,23,1999,1
chang-rae lee,Les Sombres feux du passÃ?Â©,2002,5,0,1,2000,2
chang-rae lee,Aloft,2004,6,3.857142857142857,7,2002,2
char margolis,"Questions from Earth, Answers from Heaven",2000,2,5.2,5,1999,1
charla cameron,Sultry Nights (Magnolia Road),1992,2,0,1,1991,1
charlee jacob,Haunter,2003,2,1.2,5,2002,1
charlene spretnak,Lost Goddesses of Early Greece: A Collection of Pre-Hellenic Myths With a New Preface,1992,2,0,1,1981,11
charles b. carlson,Free Lunch On Wall Street,1993,2,0,1,1992,1
charles b. carlson,Buying Stocks Without A Broker,1996,3,2,3,1993,3
charles b. carlson,No-Load Stocks: How to Buy Your First Share &amp; Every Share Directly from the Company--With No Broker's Fee,1996,4,8.5,2,1996,0
charles b. carlson,"Chuck Carlson's 60-Second Investor: 201 Tips, Tools, and Tactics for the Time-Strapped Investor",1997,5,0,1,1996,1
charles bukowski,"Love Is a Dog from Hell: Poems, 1974-1977",1977,2,0,1,1975,2
charles bukowski,Women,1978,3,4,14,1977,1
charles bukowski,Women,1978,4,1.5,2,1978,0
charles bukowski,Play the Piano Drunk Like a Percussion Instrument Until the Fingers Begin to Bleed a Bit,1979,5,5.666666666666667,6,1978,1
charles bukowski,Post Office,1980,6,5.294117647058823,17,1979,1
charles bukowski,Notes of a Dirty Old Man,1981,7,3.5714285714285716,7,1980,1
charles bukowski,Ham on Rye,1982,8,0,1,1981,1
charles bukowski,Ham on Rye,1982,9,4.611111111111111,18,1982,0
charles bukowski,The Most Beautiful Woman in Town and Other Stories,1983,10,4.571428571428571,14,1982,1
charles bukowski,Hot Water Music,1983,11,4,2,1983,0
charles bukowski,"Burning in Water, Drowning in Flame",1983,12,5,1,1983,0
charles bukowski,Tales of Ordinary Madness,1984,13,3.3333333333333335,9,1983,1
charles bukowski,Nouveaux contes de la folie ordinaire,1985,14,6,1,1984,1
charles bukowski,You Get So Alone at Times That It Just Makes Sense,1986,15,10,1,1985,1
charles bukowski,"The Roominghouse Madrigals: Early Selected Poems, 1946-1966",1988,16,0,1,1986,2
charles bukowski,Hollywood,1989,17,4,6,1988,1
charles bukowski,Hollywood,1989,18,8,1,1989,0
charles bukowski,Septuagenarian Stew: Stories and Poems,1990,19,5,2,1989,1
charles bukowski,Schlechte Verlierer. Stories.,1991,20,4.5,2,1990,1
charles bukowski,Hollywood,1992,21,3.3333333333333335,3,1991,1
charles bukowski,Au sud de nulle part,1992,22,8,1,1992,0
charles bukowski,Screams from the Balcony: Selected Letters 1960 - 1970,1993,23,9,1,1992,1
charles bukowski,Pulp,1994,24,4.333333333333333,3,1993,1
charles bukowski,Factotum,1995,25,6.333333333333333,3,1994,1
charles bukowski,"Erecciones, Eyaculaciones, Exhibiciones",1995,26,3.2,5,1995,0
charles bukowski,La Maquina de Follar,1995,27,7,1,1995,0
charles bukowski,Jeder zahlt drauf.,1995,28,8,1,1995,0
charles bukowski,Se Busca Una Mujer,1995,29,3.5,2,1995,0
charles bukowski,Shakespeare Never Did This,1995,30,0,1,1995,0
charles bukowski,Hollywood,1996,31,0,1,1995,1
charles bukowski,Faktotum.,1997,32,4,2,1996,1
charles bukowski,La Senda del Perdedor,1997,33,3.5,2,1997,0
charles bukowski,Mujeres,1997,34,8.5,2,1997,0
charles bukowski,Pulp,1997,35,4,3,1997,0
charles bukowski,Der Mann mit der Ledertasche.,1997,36,2.5,4,1997,0
charles bukowski,Pulp,1997,37,7.333333333333333,3,1997,0
charles bukowski,Das Schlimmste kommt noch oder Fast eine Jugend.,1997,38,6.666666666666667,3,1997,0
charles bukowski,Gedichte die einer schrieb bevor er im 8. Stockwerk aus dem Fenster sprang.,1998,39,9,1,1997,1
charles bukowski,What Matters Most Is How Well You Walk Through the Fire,1999,40,10,1,1998,1
charles bukowski,El Capitan Salio a Comer,2003,41,6,1,1999,4
charles carlut,French for oral and written review,1983,2,0,1,1976,7
charles cook,The Essential Guide to Wilderness Camping and Bakpbacking in the United States,1994,2,0,1,1991,3
charles dickens,A Tale of Two Cities,1960,2,3.4,5,1958,2
charles dickens,Hard Times (R),1961,3,7.75,4,1960,1
charles dickens,Hard Times,1961,4,4.8,5,1961,0
charles dickens,The Personal History of David Copperfield (Penguin Classics),1966,5,2.1,10,1961,5
charles dickens,Pickwick Papers,1968,6,2.3333333333333335,3,1966,2
charles dickens,Dombey and Son (Penguin English Library),1970,7,4.666666666666667,6,1968,2
charles dickens,Great Expectations,1970,8,0,1,1970,0
charles dickens,Great Expectations,1970,9,0,2,1970,0
charles dickens,"The Christmas Books: A Christmas Carol, the Chimes (Penguin English Library)",1971,10,1.2,5,1970,1
charles dickens,A Christmas Carol: The Original Manuscript,1971,11,0,2,1971,0
charles dickens,Our Mutual Friend (English Library),1971,12,0,4,1971,0
charles dickens,Bleak House (English Library),1971,13,2.6,15,1971,0
charles dickens,The Christmas Books Volume 2 (The Penguin English Library),1971,14,9,1,1971,0
charles dickens,A Tale of Two Cities (Amsco Literature Program - N 380 ALS),1971,15,8,1,1971,0
charles dickens,A Christmas Carol in Prose: Being a Ghost Story of Christmas,1972,16,0,2,1971,1
charles dickens,The Old Curiosity Shop (Penguin English Library El75),1972,17,2.3333333333333335,6,1972,0
charles dickens,Pickwick Club: Posthumous Papers (Penguin English Library),1973,18,5.375,8,1972,1
charles dickens,Barnaby Rudge (Penguin English Library),1974,19,3.3333333333333335,3,1973,1
charles dickens,Charles Dickens' David Copperfield,1976,20,0,1,1974,2
charles dickens,Bleak House (A Pan classic),1976,21,0,1,1976,0
charles dickens,Selected Short Fiction (Penguin English Library),1976,22,0,1,1976,0
charles dickens,"The Annotated Christmas Carol: By Charles Dickens ; Illustrated by John Leech ; With an Introd., Notes, and Bibliography by Michael Patrick Hearn.",1976,23,0,2,1976,0
charles dickens,Annotated Christmas Carol,1977,24,0,2,1976,1
charles dickens,Hard Times,1977,25,0,2,1977,0
charles dickens,"Bleak House: An Authoritative and Annotated Text, Illustrations, a Note on the Text, Genesis and Composition, Backgrounds, Criticism (A Norton)",1977,26,5,2,1977,0
charles dickens,Our Mutual Friend,1978,27,0,1,1977,1
charles dickens,Nicholas Nickleby (Penguin English Library),1978,28,6.333333333333333,3,1978,0
charles dickens,David Copperfield,1979,29,9,1,1978,1
charles dickens,"Great Expectations (Rinehart Editions, 20)",1979,30,0,1,1979,0
charles dickens,Pickwick Papers,1980,31,1.5,6,1979,1
charles dickens,A Tale of Two Cities,1980,32,8,1,1980,0
charles dickens,Great Expectations (Watermill Classic),1980,33,1.8,5,1980,0
charles dickens,Bleak House: Riverside Edition,1980,34,5,1,1980,0
charles dickens,Christmas Carol,1980,35,3.88,25,1980,0
charles dickens,Tale of Two Cities,1981,36,0.5,4,1980,1
charles dickens,Great Expectations,1981,37,0,5,1981,0
charles dickens,A Tale of Two Cities (Ladybird Children's Classics),1981,38,0,1,1981,0
charles dickens,Hard Times (Bantam Classics),1981,39,1.75,16,1981,0
charles dickens,David Copperfield (Bantam Classics),1981,40,2,9,1981,0
charles dickens,A Christmas Carol,1981,41,0,1,1981,0
charles dickens,David Copperfield,1981,42,7,1,1981,0
charles dickens,The Life of Our Lord,1981,43,5,1,1981,0
charles dickens,Great Expectations,1981,44,0,1,1981,0
charles dickens,Great Expectations,1981,45,0,2,1981,0
charles dickens,The Mystery of Edwin Drood (The World's Classics),1982,46,0,1,1981,1
charles dickens,Oliver Twist,1982,47,10,1,1982,0
charles dickens,Oliver Twist (World's Classics),1982,48,0,3,1982,0
charles dickens,A Christmas Carol (Ladybird Children's Classics),1982,49,0,1,1982,0
charles dickens,Great Expectations,1982,50,4,2,1982,0
charles dickens,Nicholas Nickleby,1982,51,0,6,1982,0
charles dickens,Great Expectations (Bantam Classic),1982,52,4.071428571428571,28,1982,0
charles dickens,Great Expectations,1982,53,0,1,1982,0
charles dickens,Dombey and Son (World's Classics),1982,54,6,1,1982,0
charles dickens,Oliver Twist (Signet Classics (Paperback)),1982,55,1.25,4,1982,0
charles dickens,Oliver Twist (Bantam Classics),1982,56,1.4285714285714286,14,1982,0
charles dickens,Nicholas Nickleby,1983,57,5.2,5,1982,1
charles dickens,David Copperfield,1983,58,5,2,1983,0
charles dickens,Bleak House,1983,59,0,1,1983,0
charles dickens,A CHRISTMAS CAROL,1983,60,5.666666666666667,6,1983,0
charles dickens,A Christmas Carol in Prose Being a Ghost Story of Christmas,1983,61,9,1,1983,0
charles dickens,David Copperfield (World's Classics),1983,62,1,5,1983,0
charles dickens,The Life and Adventures of Nicholas Nickleby: Reproduced in Facsimile from the Original Monthly Parts of 1838-9,1983,63,8,1,1983,0
charles dickens,The Pickwick Papers,1983,64,2.375,8,1983,0
charles dickens,A Christmas Carol,1983,65,9,1,1983,0
charles dickens,A Christmas Carol and Other Victorian Fairy Tales,1983,66,0,1,1983,0
charles dickens,The Complete Ghost Stories of Charles Dickens,1983,67,0,1,1983,0
charles dickens,Tale of Two Cities,1984,68,0,1,1983,1
charles dickens,A Christmas Carol,1984,69,0,1,1984,0
charles dickens,A Tale of Two Cities (World's Best Reading),1984,70,9,1,1984,0
charles dickens,Charles Dickens' a Tale of Two Cities (Barron's Book Notes),1984,71,0,1,1984,0
charles dickens,Hidden Charles Dickens,1984,72,0,1,1984,0
charles dickens,Oliver Twist (Penguin Classics),1985,73,4.3,10,1984,1
charles dickens,A Tale of Two Cities (Penguin English Library),1985,74,2.5,10,1985,0
charles dickens,A Tale of Two Cities,1985,75,3.5,2,1985,0
charles dickens,The mystery of Edwin Drood (Penguin classics),1985,76,8,1,1985,0
charles dickens,Great Expectations (English Library),1985,77,1.9655172413793103,29,1985,0
charles dickens,Hard Times for These Times (English Library),1985,78,2.85,20,1985,0
charles dickens,Great Expectations (The World's Best Reading),1985,79,0,1,1985,0
charles dickens,David Copperfield,1985,80,0,1,1985,0
charles dickens,A Tale of Two Cities,1986,81,9,1,1985,1
charles dickens,David Copperfield (The World's best reading),1986,82,0,1,1986,0
charles dickens,A Christmas Carol (Bantam Classic),1986,83,4.538461538461538,13,1986,0
charles dickens,Martin Chuzzlewit,1986,84,2,5,1986,0
charles dickens,Great Expectations (Oxford Pocket Classics),1986,85,0,1,1986,0
charles dickens,Great Expectations,1986,86,2.125,8,1986,0
charles dickens,Life and Adventures of Martin Chuzzlewit (New Oxford Illustrated Dickens),1987,87,0,1,1986,1
charles dickens,Christmas Books (The Oxford Illustrated Dickens),1987,88,0,2,1987,0
charles dickens,Christmas Stories (New Oxford Illustrated Dickens),1987,89,0,1,1987,0
charles dickens,Tale of Two Cities (New Oxford Illustrated Dickens),1987,90,0,1,1987,0
charles dickens,Hard Times for These Times (New Oxford Illustrated Dickens),1987,91,7,1,1987,0
charles dickens,"Christmas Carol, and Other Christmas Stories",1987,92,10,1,1987,0
charles dickens,Tale of Two Cities (Watermill Classics),1987,93,3,6,1987,0
charles dickens,Little Dorrit (New Oxford Illustrated Dickens),1987,94,0,2,1987,0
charles dickens,A Christmas Carol,1987,95,10,1,1987,0
charles dickens,David Copperfield (Signet Classics (Paperback)),1987,96,2.8333333333333335,12,1987,0
charles dickens,Oliver Twist (The World's best reading),1987,97,0,2,1987,0
charles dickens,Personal History of David Copperfield (New Oxford Illustrated Dickens),1987,98,0,1,1987,0
charles dickens,Tale Of Two Cities (Greenwich House Classics Library),1988,99,5,1,1987,1
charles dickens,The Old Curiosity Shop (The World's Best Reading),1988,100,0,1,1988,0
charles dickens,The Life and Adventures of Nicholas Nickleby,1988,101,0,2,1988,0
charles dickens,WeihnachtsmÃ?Â¤rchen / WeihnachtserzÃ?Â¤hlungen.,1988,102,8,1,1988,0
charles dickens,The Mystery of Edwin Drood (Penguin Classics),1988,103,0,4,1988,0
charles dickens,A Christmas Carol,1988,104,10,1,1988,0
charles dickens,The Pickwick Papers (World's Classics),1988,105,0,1,1988,0
charles dickens,Hard Times (Watermill),1988,106,0.6,10,1988,0
charles dickens,David Copperfield,1989,107,0,1,1988,1
charles dickens,Great Expectations (Literature for Christian Schools Ser.),1989,108,8,1,1989,0
charles dickens,David Copperfield (Norton Critical Edition),1989,109,8.5,2,1989,0
charles dickens,A Tale of Two Cities,1989,110,5.2,5,1989,0
charles dickens,Oliver Twist (Great Illustrated Classics),1989,111,3.4,5,1989,0
charles dickens,Treasury of Charles Dickens,1989,112,0,1,1989,0
charles dickens,Hard Times (World's Classics),1989,113,0,4,1989,0
charles dickens,Tale of Two Cities (Bantam Classic),1989,114,2.3636363636363638,33,1989,0
charles dickens,A Tale of Two Cities,1989,115,0,1,1989,0
charles dickens,Bleak House,1989,116,10,1,1989,0
charles dickens,Nicholas Nickleby (The Worlds Classics),1990,117,0,1,1989,1
charles dickens,A Christmas Carol (Apple Classics),1990,118,1.4285714285714286,7,1990,0
charles dickens,"Hard Times: An Authoritative Text, Backgrounds, Sources, and Contemporary Reactions, Criticism (Norton Critical Edition)",1990,119,2.8333333333333335,6,1990,0
charles dickens,A Christmas Carol (Classics Illustrated),1990,120,0,1,1990,0
charles dickens,A Christmas Carol,1990,121,9,1,1990,0
charles dickens,Christmas Carol (Classic Library),1990,122,2.5,2,1990,0
charles dickens,A Christmas Carol (Running Press Miniature Editions),1990,123,4,2,1990,0
charles dickens,Great Expectations (Classics Illustrated),1990,124,0,2,1990,0
charles dickens,A Tale of Two Cities (Vintage Classics),1990,125,2.5,2,1990,0
charles dickens,A Christmas Carol in Prose Being a Ghost Story of Christmas: In Prose : Being a Ghost Story of Christmas,1990,126,1.8,5,1990,0
charles dickens,Mystery of Edwin Drood,1991,127,0,1,1990,1
charles dickens,Tale of Two Cities,1991,128,1.2,15,1991,0
charles dickens,The Pickwick Papers,1991,129,0,2,1991,0
charles dickens,A CHRISTMAS CAROL A (REISSUE)  CASSETTE,1991,130,6.5,4,1991,0
charles dickens,David Copperfield (Everyman's Library),1991,131,10,1,1991,0
charles dickens,"Charles Dickens Four Complete Novels (Great Expectations, Hard Times, A Christmas Carol, A Tale of Two Cities)",1991,132,7,4,1991,0
charles dickens,Great Expectations (Puffin Classics),1991,133,3,3,1991,0
charles dickens,A Christmas Carol (Dover Thrift Editions),1991,134,6.444444444444445,9,1991,0
charles dickens,The Personal History of David Copperfield (The World's Great Books),1991,135,0,1,1991,0
charles dickens,David Copperfield (Great Illustrated Classics),1992,136,1.6666666666666667,3,1991,1
charles dickens,Oliver Twist (Everyman's Library),1992,137,10,1,1992,0
charles dickens,A Christmas Carol (Watermill Classics),1992,138,5,1,1992,0
charles dickens,The Cricket on the Hearth (Bcl1-Pr English Literature),1992,139,0,1,1992,0
charles dickens,Great Expectations (Oxford Bookworms),1992,140,2,3,1992,0
charles dickens,Great Expectations (Courage Literary Classics),1992,141,2.8333333333333335,6,1992,0
charles dickens,Great Expectations (Great Illustrated Classics),1992,142,0,4,1992,0
charles dickens,A Tale of Two Cities (Courage classics),1992,143,0,1,1992,0
charles dickens,The D. Case: Or The Truth About The Mystery Of Edwin Drood,1993,144,2,7,1992,1
charles dickens,Oliver Twist,1993,145,4,2,1993,0
charles dickens,Oliver Twist (Landoll Classics),1993,146,10,1,1993,0
charles dickens,New Windmill Classics: Oliver Twist (New Windmills),1993,147,7,1,1993,0
charles dickens,Oliver Twist (Children's Classics),1993,148,7,1,1993,0
charles dickens,Hard Times,1993,149,0,1,1993,0
charles dickens,The Bedside Dickens (Classics for Pleasure),1993,150,5,1,1993,0
charles dickens,David Copperfield (Everyman Paperback Classics),1993,151,7,1,1993,0
charles dickens,Great Expectations (Longman Literature),1993,152,8,1,1993,0
charles dickens,The Life and Adventures of Nicholas Nickleby,1993,153,0,1,1993,0
charles dickens,A Tale of Two Cities (Everyman's Library Series),1993,154,0,1,1993,0
charles dickens,Nicholas Nickleby (Everyman's Library),1993,155,0,1,1993,0
charles dickens,Oliver Twist (Bullseye Step Into Classics),1994,156,2.25,4,1993,1
charles dickens,Bleak House (Penguin Popular Classics),1994,157,1.4,5,1994,0
charles dickens,Little Dorrit (Penguin Popular Classics),1994,158,1.1666666666666667,6,1994,0
charles dickens,Bleak House (Everyman's Library (Paper)),1994,159,10,1,1994,0
charles dickens,David Copperfield (Penguin Popular Classics),1994,160,2.3333333333333335,9,1994,0
charles dickens,Tale of Two Cities,1994,161,5,2,1994,0
charles dickens,The Christmas Books (Penguin Popular Classics),1994,162,3.25,12,1994,0
charles dickens,The Adventures of Oliver Twist (Everyman's Library (Paper)),1994,163,4,2,1994,0
charles dickens,Great Expectations (The World's Classics),1994,164,0,1,1994,0
charles dickens,The Cricket on the Hearth and Other Christmas Stories (Dover Thrift Editions),1994,165,0,11,1994,0
charles dickens,Martin Chuzzlewit,1994,166,0,1,1994,0
charles dickens,Martin Chuzzlewit (Penguin Popular Classics),1994,167,0,1,1994,0
charles dickens,"Charles Dickens: Great Expectations, Hard Times, the Cricket on the Hearth (Great Classic Library)",1994,168,0,1,1994,0
charles dickens,Hard Times. for These Times (Everyman's Library (Paper)),1994,169,5,1,1994,0
charles dickens,Nicholas Nickleby (Penguin Popular Classics),1994,170,0,1,1994,0
charles dickens,Hard Times (Penguin Popular Classics),1994,171,0.9,10,1994,0
charles dickens,Pickwick Papers (Penguin Popular Classics),1994,172,3.2,5,1994,0
charles dickens,A Treasury of Christmas Classics: Including a Christmas Carol,1994,173,0,1,1994,0
charles dickens,Oliver Twist (Puffin Classics),1994,174,0,3,1994,0
charles dickens,Christmas Carol: And Other Christmas Stories (Signet Classic),1994,175,5.4,10,1994,0
charles dickens,A Christmas Carol,1994,176,0,1,1994,0
charles dickens,A Christmas Carol and Other Stories (Modern Library),1995,177,5,1,1994,1
charles dickens,Great Expectations (Puffin Classics),1995,178,1.6666666666666667,3,1995,0
charles dickens,Little Dorrit (Penguin Classics),1995,179,3.2,5,1995,0
charles dickens,Charles Dickens Great Expectations (Case Studies in Contemporary Criticism (Paper)),1995,180,4,2,1995,0
charles dickens,David Copperfield (Illustrated Classics),1995,181,7,1,1995,0
charles dickens,A Christmas Carol (Puffin Classics (Paperback)),1995,182,0,2,1995,0
charles dickens,Bleak House (Bantam Classics),1995,183,1.3,10,1995,0
charles dickens,Oliver Twist,1995,184,0,1,1995,0
charles dickens,David Copperfield,1995,185,0,1,1995,0
charles dickens,Martin Chuzzlewit,1995,186,0,1,1995,0
charles dickens,A TALE OF TWO CITIES  (ENRICHED CLASSIC),1996,187,0,2,1995,1
charles dickens,Oliver Twist (Giant Literary Classics),1996,188,0,1,1996,0
charles dickens,Hard Times: For These Times,1996,189,10,1,1996,0
charles dickens,A Tale of Two Cities (Puffin Classics),1996,190,1.6,5,1996,0
charles dickens,"Christmas Stories: A Christmas Carol, the Chimes, the Cricket on the Hearth, the Haunted Man, a Christmas Tree, What Christmas Is As We Grow Older, the Poor Relation's",1996,191,7,1,1996,0
charles dickens,A Tale of Two Cities (Modern Library),1996,192,5,1,1996,0
charles dickens,Oliver Twist. ( Ab 11 J.).,1996,193,7.333333333333333,3,1996,0
charles dickens,The Pickwick Papers (Penguin Classics),1997,194,6,1,1996,1
charles dickens,David Copperfield (World's Classics),1997,195,0,1,1997,0
charles dickens,David Copperfield (Wordsworth Classics),1997,196,2.608695652173913,23,1997,0
charles dickens,David Copperfield (Penguin Classics),1997,197,3.5,12,1997,0
charles dickens,Bleak House (Wordsworth Classics),1997,198,3.8461538461538463,13,1997,0
charles dickens,Oliver Twist (Wordsworth Classics),1997,199,1.5555555555555556,18,1997,0
charles dickens,A Tale of Two Cities,1997,200,3.32,25,1997,0
charles dickens,Great Expectations (Wordsworth Classics),1997,201,3.25,28,1997,0
charles dickens,A Tale of Two Cities (Wordsworth Classics),1997,202,1.5909090909090908,22,1997,0
charles dickens,Hard Times: For These Times,1997,203,1,3,1997,0
charles dickens,A Christmas Carol,1997,204,0,1,1997,0
charles dickens,Great Expectations (Signet Classics (Paperback)),1998,205,2.6666666666666665,12,1997,1
charles dickens,Great Expectations (Oxford World's Classics),1998,206,4.666666666666667,15,1998,0
charles dickens,Hard Times (Wordsworth Collection),1998,207,2.111111111111111,9,1998,0
charles dickens,Hard Times,1998,208,0,7,1998,0
charles dickens,Our Mutual Friend (Wordsworth Collection),1998,209,2.6666666666666665,3,1998,0
charles dickens,Christmas Books (Oxford World's Classics),1998,210,6.5,2,1998,0
charles dickens,David Copperfield (David Copperfield),1998,211,5,1,1998,0
charles dickens,Hard Times (Oxford World's Classics),1998,212,2.8,5,1998,0
charles dickens,Martin Chuzzlewit (Wordsworth Collection),1998,213,0,4,1998,0
charles dickens,Oliver Twist,1998,214,9,3,1998,0
charles dickens,The Mystery of Edwin Drood and Other Stories (Classics Library (NTC)),1998,215,3,2,1998,0
charles dickens,A Tale of Two Cities (Oxford World's Classics),1998,216,3.5,6,1998,0
charles dickens,Nicholas Nickleby (Wordsworth Collection),1998,217,1.3333333333333333,6,1998,0
charles dickens,Little Dorrit (Penguin Classics),1998,218,0,1,1998,0
charles dickens,A Christmas Carol (Wordsworth Collection),1998,219,4.5,2,1998,0
charles dickens,Oliver Twist (Oxford World's Classics),1998,220,7,1,1998,0
charles dickens,Our Mutual Friend (Penguin Classics),1998,221,5,2,1998,0
charles dickens,Old Curiosity Shop (Wordsworth Collection),1998,222,3.1538461538461537,13,1998,0
charles dickens,David Copperfield,1998,223,0,1,1998,0
charles dickens,GHOST STORIES,1998,224,4,2,1998,0
charles dickens,Pickwick Papers (Wordsworth Collection),1998,225,0.9090909090909091,11,1998,0
charles dickens,Bleak House (Oxford World's Classics),1998,226,2,6,1998,0
charles dickens,Great Expectations,1998,227,2.6666666666666665,18,1998,0
charles dickens,The Pickwick Papers (Oxford World's Classics),1998,228,3.3333333333333335,3,1998,0
charles dickens,Great Expectations,1998,229,0,1,1998,0
charles dickens,Little Dorrit (Wordsworth Collection),1998,230,3.3333333333333335,3,1998,0
charles dickens,Great Expectations,1998,231,4.6,5,1998,0
charles dickens,The Old Curiosity Shop: With the Original Illustrations (Oxford World's Classics),1998,232,9,1,1998,0
charles dickens,Dombey and Son,1999,233,0,3,1998,1
charles dickens,"The Unabridged Charles Dickens: A Tale of Two Cities, Oliver Twist, Great Expectations (Courage Classics)",1999,234,1.6666666666666667,3,1999,0
charles dickens,Nicholas Nickleby (Penguin Classics),1999,235,4.25,4,1999,0
charles dickens,A Tale of Two Cities (Dover Thrift Editions),1999,236,3.375,8,1999,0
charles dickens,David Copperfield (Oxford World's Classics Hardcovers),1999,237,0,1,1999,0
charles dickens,The Pickwick Papers (BBC Radio Presents),1999,238,0,1,1999,0
charles dickens,Oliver Twist (Oxford World's Classics),1999,239,2.5,4,1999,0
charles dickens,Hard Times (Bantam Classics),1999,240,0,1,1999,0
charles dickens,Great Expectations (Konemann Classics),1999,241,0,1,1999,0
charles dickens,Barnaby Rudge,1999,242,1.25,4,1999,0
charles dickens,A Tale of Two Cities,1999,243,0,1,1999,0
charles dickens,Great Expectations (Oxford World's Classics (Hardcover)),1999,244,7,1,1999,0
charles dickens,David Copperfield (Oxford World's Classics),1999,245,3,2,1999,0
charles dickens,The Signalman &amp; Other Ghost Stories (Pocket Classics and Other Literature),1999,246,7,1,1999,0
charles dickens,A Tale of Two Cities (Courage Literary Classics),1999,247,0,1,1999,0
charles dickens,A Christmas Carol (Great Stories),1999,248,10,1,1999,0
charles dickens,Oliver Twist,1999,249,0,1,1999,0
charles dickens,Great Expectations,2000,250,0,5,1999,1
charles dickens,Great Expectations: By Charles Dickens,2000,251,8,1,2000,0
charles dickens,CanciÃ³n de Navidad,2000,252,2,4,2000,0
charles dickens,Stories For Christmas,2000,253,4,2,2000,0
charles dickens,A Tale of Two Cities (Penguin Classics),2000,254,7.5,2,2000,0
charles dickens,"Hard Times, Third Edition (Norton Critical Editions)",2000,255,7.5,2,2000,0
charles dickens,David Copperfield: Level 5 (Bookworms Series),2000,256,0,1,2000,0
charles dickens,Great Expectations,2000,257,0,2,2000,0
charles dickens,Tale of Two Cities,2000,258,10,1,2000,0
charles dickens,A Christmas Carol (Scholastic Classics),2000,259,3.625,8,2000,0
charles dickens,Signature Classics : A Christmas Carol,2000,260,0,3,2000,0
charles dickens,David Copperfield (Modern Library Classics),2000,261,6,4,2000,0
charles dickens,Tale of Two Cities,2000,262,0,1,2000,0
charles dickens,The Pickwick Papers (Penguin Classics),2000,263,0,4,2000,0
charles dickens,Oliver Twist,2000,264,7,1,2000,0
charles dickens,"Oliver Twist (Penguin Readers, Level 4)",2001,265,0,1,2000,1
charles dickens,A Christmas Carol: And Other Stories (Modern Library Classics),2001,266,5,1,2001,0
charles dickens,Dombey and Son (Oxford World's Classics),2001,267,4.5,2,2001,0
charles dickens,Weihnachtslied. Eine Gespenstergeschichte.,2001,268,7,1,2001,0
charles dickens,Oliver Twist (Modern Library Classics),2001,269,5,1,2001,0
charles dickens,Great Expectations (Modern Library Classics),2001,270,3.5,4,2001,0
charles dickens,Hard Times (Dover Thrift Editions),2001,271,0,2,2001,0
charles dickens,American Notes for General Circulation (Penguin Classics),2001,272,2.3333333333333335,3,2001,0
charles dickens,Hard Times (Modern Library Classics),2001,273,5,1,2001,0
charles dickens,Great Expectations (Dover Thrift Editions),2001,274,4.333333333333333,6,2001,0
charles dickens,Our Mutual Friend,2001,275,8,2,2001,0
charles dickens,Oliver Twist (Dover Thrift Editions),2002,276,2.5,2,2001,1
charles dickens,Our Mutual Friend (Modern Library Classics),2002,277,0,1,2002,0
charles dickens,Bleak House (Modern Library Classics),2002,278,2.5,2,2002,0
charles dickens,Great Expectations,2002,279,0,1,2002,0
charles dickens,The Mystery of Edwin Drood (Penguin Classics),2002,280,10,1,2002,0
charles dickens,Little Dorrit (Modern Library Classics),2002,281,2.5,2,2002,0
charles dickens,Nicholas Nickelby,2002,282,0,2,2002,0
charles dickens,Dombey and Son (Penguin Classics),2002,283,0,1,2002,0
charles dickens,Great Expectations (Scholastic Classics),2003,284,0,1,2002,1
charles dickens,Bleak House (Penguin Classics),2003,285,0,2,2003,0
charles dickens,Hard Times,2003,286,0,2,2003,0
charles dickens,Bleak House,2003,287,10,1,2003,0
charles dickens,A Tale of Two Cities (Penguin Classics),2003,288,5,2,2003,0
charles dickens,Oliver Twist (Penguin Classics),2003,289,1.6,10,2003,0
charles dickens,Bleak House (Signet Classics (Paperback)),2003,290,1,2,2003,0
charles dickens,The Old Curiosity Shop (Dover Thrift Editions),2003,291,0,1,2003,0
charles dickens,David Copperfield (Barnes &amp; Noble Classics),2003,292,0,1,2003,0
charles dickens,Dombey and Son (The Modern Library Classics),2003,293,5,1,2003,0
charles dickens,OLIVER TWIST (B&amp;N Classics Mass Market),2003,294,0,1,2003,0
charles dickens,A Child's History of England,2003,295,0,1,2003,0
charles dickens,Great Expectations (Penguin Classics),2003,296,2.4615384615384617,13,2003,0
charles dickens,A Christmas Carol (Tor Classics),2004,297,3.3333333333333335,3,2003,1
charles dickens,Christmas Books,2004,298,2.6,5,2004,0
charles dickinson,Widows' Adventures: A Novel,1989,2,0,1,1986,3
charles dickinson,Widow's Adventures: A Novel,1990,3,2.8,5,1989,1
charles dickinson,Rumor Has It,1991,4,1.6,5,1990,1
charles dickinson,Crows,1993,5,0,1,1991,2
charles dickinson,A Shortcut in Time,2003,6,4.5,2,1993,10
charles dickinson,A Shortcut in Time,2004,7,4.75,4,2003,1
charles e. bressler,Literary Criticism: An Introduction to Theory and Practice (3rd Edition),2002,2,0,1,1994,8
charles g. west,Wind River (Little Wolf),1999,2,0,1,1999,0
charles g. west,Wings of the Hawk (Hawk),2000,3,7,2,1999,1
charles g. west,Savage Cry,2002,4,0,1,2000,2
charles givens,FINANCIAL SELF DEFENSE,1990,2,2.6,5,1988,2
charles givens,MORE WEALTH WITHOUT RISK,1991,3,2.8,5,1990,1
charles givens,Wealth Without Risk for Canadians,1992,4,0,2,1991,1
charles laird calia,The Unspeakable,1999,2,1.3333333333333333,6,1998,1
charles m. sevilla,Disorder in the Court: Great Fractured Moments in Courtroom History,1999,2,4.25,4,1992,7
charles maclean,The Watcher,1984,2,0,2,1980,4
charles nordhoff,Mutiny on the Bounty: A Novel,1989,2,0,2,1989,0
charles osborne,Black Coffee (Hercule Poirot Mysteries (Hardcover)),1998,2,2.75,8,1992,6
charles osborne,Black Coffee (Hercule Poirot Mysteries (Hardcover)),1998,3,0,1,1998,0
charles osborne,Black Coffee: A Hercule Poirot Novel (Hercule Poirot Mysteries (Paperback)),1999,4,3.375,16,1998,1
charles osborne,The Unexpected Guest,1999,5,1.05,20,1999,0
charles osborne,Spider's Web,2000,6,3.25,8,1999,1
charles osborne,The Importance of Being Earnest: A Trivial Novel for Serious People,2000,7,8,2,2000,0
charles osborne,The Life and Crimes of Agatha Christie: A Biographical Companion to the Works of Agatha Christie,2001,8,8,1,2000,1
charles osborne,The Life and Crimes of Agatha Christie: A Biographical Companion to the Works of Agatha Christie,2002,9,10,1,2001,1
charles r. pellegrino,Sodom &amp; Gomorrah,1995,2,0,1,1990,5
charles r. pellegrino,Dust,1999,3,3.8,5,1995,4
charles r. pellegrino,Ghosts of the Titanic,2001,4,10,1,1999,2
charles r. pellegrino,"Ghosts of Vesuvius: A New Look at the Last Days of Pompeii, How Towers Fall, and Other Strange Connections",2004,5,0,1,2001,3
charles r. schwab,You're Fifty--Now What?: Investing for the Second Half of Your Life,2000,2,4,2,1998,2
charles r. swindoll,Three Steps Forward Two Steps Back,1980,2,1.1428571428571428,7,1978,2
charles r. swindoll,For Those Who Hurt,1980,3,0,1,1980,0
charles r. swindoll,Three Steps Forward Two Steps Back,1980,4,0,1,1980,0
charles r. swindoll,Strike the Original Match,1981,5,0,4,1980,1
charles r. swindoll,"Three Steps Forward, Two Steps Back",1982,6,8,1,1981,1
charles r. swindoll,Hand Me Another Brick,1983,7,0,2,1982,1
charles r. swindoll,Come Before Winter and Share My Hope,1985,8,0,3,1983,2
charles r. swindoll,"3 Steps Forward, 2 Steps Back: Persevering Through Pressure",1985,9,0,1,1985,0
charles r. swindoll,"Three Steps Forward, Two Steps Back",1985,10,0,4,1985,0
charles r. swindoll,Growing Deep in Christian Life,1986,11,3.3333333333333335,3,1985,1
charles r. swindoll,Improving Your Serve: The Art of Unselfish Living,1986,12,3,2,1986,0
charles r. swindoll,The Quest for Character,1987,13,0,1,1986,1
charles r. swindoll,Growing Deep In Christian Life,1987,14,0,1,1987,0
charles r. swindoll,Living Above Level of Mediocrity Study Guide,1987,15,0,1,1987,0
charles r. swindoll,Strike the Original Match,1990,16,6,1,1987,3
charles r. swindoll,Growing Strong In the Seasons of Life,1990,17,3,3,1990,0
charles r. swindoll,Improving Your Serve,1990,18,0,1,1990,0
charles r. swindoll,Strong Family,1991,19,0,2,1990,1
charles r. swindoll,Laugh Again,1992,20,6,1,1991,1
charles r. swindoll,The Grace Awakening (Walker Large Print Books),1992,21,10,1,1992,0
charles r. swindoll,Flying Closer to the Flame: A Passion for the Holy Spirit,1993,22,0,1,1992,1
charles r. swindoll,Second Wind: Fresh Hope for the Road Ahead,1993,23,0,1,1993,0
charles r. swindoll,Encourage Me,1993,24,3.5,2,1993,0
charles r. swindoll,Come Before Winter and Share My Hope,1994,25,0,1,1993,1
charles r. swindoll,Active Spirituality: A Non-Devotional Guide,1994,26,7,1,1994,0
charles r. swindoll,Laugh Again,1995,27,8,1,1994,1
charles r. swindoll,Paw Paw Chuck's Big Ideas In The Bible - Book,1995,28,0,1,1995,0
charles r. swindoll,Daniel (Swindoll Bible Study Guides),1996,29,0,1,1995,1
charles r. swindoll,Dear Graduate: Letters of Wisdom from Charles Swindoll,1996,30,7,1,1996,0
charles r. swindoll,Hope Again,1996,31,5.666666666666667,3,1996,0
charles r. swindoll,Intimacy With The Almighty,1996,32,9,1,1996,0
charles r. swindoll,Come Before Winter and Share My Hope,1997,33,0,1,1996,1
charles r. swindoll,Improving Your Serve,1997,34,0,1,1997,0
charles r. swindoll,Hope Again,1997,35,0,1,1997,0
charles r. swindoll,Esther Great Lives Series: Volume 2,1997,36,0,2,1997,0
charles r. swindoll,Strike the Original Match,1998,37,6,1,1997,1
charles r. swindoll,Laugh Again: Philippians,1998,38,0,1,1998,0
charles r. swindoll,Learning to Walk by Grace,1998,39,0,1,1998,0
charles r. swindoll,The Tale Of The Tardy Oxcart,1998,40,10,1,1998,0
charles r. swindoll,"Elijah Great Lives, Volume 5",2000,41,0,1,1998,2
charles r. swindoll,Perfect Trust,2000,42,4,2,2000,0
charles r. swindoll,Wisdom For The Way Wise Words For Busy People,2001,43,0,2,2000,1
charles r. swindoll,"Paul: A Man of Grit and Grace (Great Lives from God's Word, Volume 6)",2002,44,0,1,2001,1
charles r. swindoll,Simple Faith,2003,45,0,1,2002,1
charles r. swindoll,Behold... The Man!,2004,46,0,1,2003,1
charles r. swindoll,Job: A Man of Heroic Endurance (Great Lives from God's Word),2004,47,9,1,2004,0
charles reasoner,Who's Peeking (A Sliding Surprise Book),1993,2,0,1,1993,0
charles reasoner,Color Crunch! (Bite Books),1996,3,0,1,1993,3
charles reasoner,Number Munch! (Mini Bites),1998,4,0,1,1996,2
charles robertson,The Children,1982,2,0,3,1982,0
charles robertson,Red Chameleon,1985,3,4.333333333333333,3,1982,3
charles robertson,STRIKE ZONE,1990,4,0,1,1985,5
charles schulz,Charlie Browns Cyclopedia Volume 2,1980,2,0,1,1979,1
charles schulz,Charlie Browns Cyclopedia Volume 6,1980,3,0,2,1980,0
charles schulz,Take It Easy Charlie Brown,1983,4,3.5,2,1980,3
charles schulz,"You're Our Kind of Dog, Snoopy",1985,5,4,2,1983,2
charles schulz,"She Likes You, Charlie Brown (Selected Cartoons from I'm Not Your Sweet Babboo, Vol 2)",1986,6,7,1,1985,1
charles schulz,Snoopy's Book of Colors (Golden Books for Beginners),1987,7,3.5,2,1986,1
charles schulz,Snoopy's Word Book (Golden Books for Beginners),1987,8,1.6666666666666667,3,1987,0
charles schulz,"Snoopy's A,b,c's Concept bks (Golden Books for Beginners)",1987,9,0,2,1987,0
charles schulz,"Get Physical, Snoopy! (I'm Not Your Sweet Babboo!, Vol III)",1990,10,0,1,1987,3
charles schulz,"Hold the Fort, Snoopy!",1992,11,0,1,1990,2
charles schulz,Insights from the Outfield (Peanuts at Work &amp; Play),1997,12,5.166666666666667,6,1992,5
charles sheffield,My Brothers Keeper,1982,2,4,2,1981,1
charles sheffield,The SELKIE,1982,3,7,1,1982,0
charles sheffield,The Web Between the Worlds,1984,4,5,1,1982,2
charles sheffield,BETWEEN THE STROKES OF NIGHT,1985,5,0,2,1984,1
charles sheffield,The McAndrew Chronicles,1988,6,9,2,1985,3
charles sheffield,"Summertide (The Heritage Universe, Book 1)",1990,7,0,1,1988,2
charles sheffield,BROTHER TO DRAGONS,1992,8,4.5,2,1990,2
charles sheffield,Cold As Ice,1993,9,1.4,5,1992,1
charles sheffield,The Mind Pool,1993,10,4,7,1993,0
charles sheffield,DANCING WITH MYSELF : A Constable Ben Cooper Novel,1993,11,0,1,1993,0
charles sheffield,Godspeed,1993,12,0,2,1993,0
charles sheffield,Godspeed,1994,13,0,1,1993,1
charles sheffield,The Judas Cross,1994,14,1.6666666666666667,3,1994,0
charles sheffield,PROTEUS COMBINED,1994,15,7.5,2,1994,0
charles sheffield,The Ganymede Club,1995,16,1.75,4,1994,1
charles sheffield,Proteus Underworld,1995,17,0,1,1995,0
charles sheffield,Tomorrow and Tomorrow (Bantam Spectra Book),1996,18,0,2,1995,1
charles sheffield,The Ganymede Club (Ganymede Club),1996,19,2.6666666666666665,3,1996,0
charles sheffield,Higher Education: A Jupiter Novel (Jupiter Novel),1996,20,0,1,1996,0
charles sheffield,The Billion Dollar Boy (Jupiter Novel),1997,21,5,1,1996,1
charles sheffield,"""CONVERGENCE (\Heritage Universe"""" Series)""""""",1997,22,2,3,1997,0
charles sheffield,Higher Education: A Jupiter Novel (Jupiter Novel),1997,23,0,3,1997,0
charles sheffield,Convergent Series,1998,24,0,2,1997,1
charles sheffield,Putting Up Roots: A Jupiter Novel,1998,25,5,2,1998,0
charles sheffield,The Billion Dollar Boy: A Jupiter Novel (Jupiter Novel),1998,26,0,1,1998,0
charles sheffield,Tomorrow &amp; Tomorrow,1998,27,2.3333333333333335,3,1998,0
charles sheffield,Aftermath,1999,28,3.625,8,1998,1
charles sheffield,The Cyborg from Earth: A Jupiter Novel (Jupiter Novel),1999,29,6,1,1999,0
charles sheffield,Star Fire (Bantam Spectra Book),1999,30,0,2,1999,0
charles sheffield,Transvergence,1999,31,2.5,2,1999,0
charles sheffield,Starfire (Bantam Spectra),2000,32,0,3,1999,1
charles sheffield,Borderlands of Science,2000,33,4.5,2,2000,0
charles sheffield,My Brother's Keeper,2000,34,0,3,2000,0
charles sheffield,The Spheres of Heaven,2001,35,0,1,2000,1
charles sheffield,The Amazing Dr. Darwin,2002,36,0,1,2001,1
charles sheffield,Dark as Day (Cold As Ice),2002,37,4.5,2,2002,0
charles sheffield,The Spheres of Heaven,2002,38,0,2,2002,0
charles sheffield,The Amazing Dr. Darwin : The Adventures of Charles Darwin's Grandfather,2003,39,3,2,2002,1
charles stross,Singularity Sky,2003,2,5.333333333333333,3,2002,1
charles stross,Singularity Sky,2004,3,0,1,2003,1
charles stross,Iron Sunrise,2004,4,9,1,2004,0
charles whitfield,A Gift to Myself,1990,2,2,3,1987,3
charles winecoff,Split Image: The Life of Anthony Perkins,1997,2,0,2,1996,1
charlie mcdade,Gray Knight,1994,2,6,1,1991,3
charlie mcdade,8 Seconds,1994,3,0,2,1994,0
charlie smith,Canaan,1986,2,0,1,1984,2
charlie smith,Cheap Ticket to Heaven,1996,3,0,1,1986,10
charlie smith,Chimney Rock: A Novel,1997,4,2.5,2,1996,1
charlie smith,Cheap Ticket to Heaven: A Novel,1997,5,3.5,2,1997,0
charlotte bingham,To Hear a Nightingale,1990,2,3.75,4,1989,1
charlotte bingham,The Nightingale Sings,1996,3,5,1,1990,6
charlotte bingham,Belgravia,2000,4,0,1,1996,4
charlotte bingham,The Chestnut Tree: A Novel of the Women of World War II,2003,5,9,1,2000,3
charlotte bingham,The Wind Off the Sea: A Novel of the Women Who Prevailed After WWII,2004,6,10,1,2003,1
charlotte graeber,Fudge : Fudge,1989,2,0,1,1985,4
charlotte graeber,Nobody's Dog,1998,3,3,3,1989,9
charlotte lamb,A Frozen Fire,1980,2,0,2,1978,2
charlotte lamb,Dark Dominion,1980,3,0,5,1980,0
charlotte lamb,"Frustration (Harlequin Presents, 339)",1980,4,0,2,1980,0
charlotte lamb,"Compulsion (Harlequin Presents, 422)",1980,5,0,3,1980,0
charlotte lamb,Twist of Fate,1980,6,0,2,1980,0
charlotte lamb,The Silken Trap,1980,7,0,1,1980,0
charlotte lamb,"Retribution (Harlequin Romance, 442)",1981,8,0,1,1980,1
charlotte lamb,Seduction,1981,9,0,1,1981,0
charlotte lamb,"Crescendo (Harlequin Presents, #451)",1981,10,0,1,1981,0
charlotte lamb,"Stranger in the Night (Harlequin Presents, 417)",1981,11,0,2,1981,0
charlotte lamb,Abduction,1981,12,0,1,1981,0
charlotte lamb,Illusion ( Harlequin Presents ) (448),1981,13,0,1,1981,0
charlotte lamb,Girl from Nowhere (Harlequin Presents),1982,14,0,2,1981,1
charlotte lamb,Midnight Lover (Harlequin Presents),1982,15,0,1,1982,0
charlotte lamb,"Man's World (Harlequin Romance, 412)",1983,16,0,2,1982,1
charlotte lamb,Wild Affair (Harlequin Presents),1983,17,0,2,1983,0
charlotte lamb,Betrayal (Harlequin Presents),1983,18,0,4,1983,0
charlotte lamb,Haunted (Harlequin Presents),1983,19,0,3,1983,0
charlotte lamb,Darkness Of The He (Harlequin Presents),1984,20,0,2,1983,1
charlotte lamb,Scandalous,1984,21,0,1,1984,0
charlotte lamb,Naked Flame,1984,22,3,2,1984,0
charlotte lamb,Kingfisher Morning,1985,23,0,1,1984,1
charlotte lamb,"Who'S Been Sleep/Bed (Harlequin Presents, No 842)",1985,24,0,3,1985,0
charlotte lamb,"Sleeping Desire (Harlequin Presents, No 851)",1985,25,0,1,1985,0
charlotte lamb,Man Hunt (Harlequin Presents),1985,26,1.3333333333333333,3,1985,0
charlotte lamb,Love Games,1985,27,0,3,1985,0
charlotte lamb,For Adults Only,1985,28,0,1,1985,0
charlotte lamb,Bride Said No (Harlequin Presents),1986,29,0,1,1985,1
charlotte lamb,"Explosive Meeting (Harlequin Presents, No 898)",1986,30,0,2,1986,0
charlotte lamb,"Heron Quest (Harlequin Romance, No 2804)",1986,31,0,1,1986,0
charlotte lamb,Heat Of The Night (Harlequin Presents No. 971),1987,32,0,2,1986,1
charlotte lamb,"Hide And Seek (Harlequin Presents, No.1001)",1987,33,0,3,1987,0
charlotte lamb,"Love In The Dark (Harlequin Presents, No 987)",1987,34,0,1,1987,0
charlotte lamb,"Kiss Of Fire (Harlequin Presents, No 1042)",1987,35,7,1,1987,0
charlotte lamb,"Out Of Control (Harlequin Presents, No 1106)",1988,36,0,1,1987,1
charlotte lamb,Echo Of Passion,1988,37,0,3,1988,0
charlotte lamb,"Whirlwind (Harlequin Presents, No 1059)",1988,38,0,1,1988,0
charlotte lamb,Un Tendre Secret,1994,39,0,1,1988,6
charlotte lamb,Walking in Darkness,1996,40,0,3,1994,2
charlotte lamb,In the Still of the Night (In Still of the Night),1997,41,0,1,1996,1
charlotte lamb,"Boss'S Virgin (9 To 5) (Harlequin Presents, No. 2214)",2001,42,0,1,1997,4
charlotte lamb,Angel of Death,2001,43,7,1,2001,0
charlotte lamb,Treasons of the Heart,2002,44,2,2,2001,1
charlotte lamb,Deep and Silent Waters,2002,45,0,3,2002,0
charlotte paul,A child is missing,1978,2,0,2,1978,0
charlotte paul,Image,1980,3,0,6,1978,2
charlotte paul,Phoenix Island,1987,4,0,2,1980,7
charlotte paul,Seattle,1987,5,0,2,1987,0
charlotte towner graeber,Fudge,1988,2,0,1,1984,4
charlotte zolotow,Mr. Rabbit and the Lovely Present,1977,2,2.3333333333333335,3,1962,15
charlotte zolotow,River Winding,1978,3,0,1,1977,1
charlotte zolotow,Summer Is,1983,4,0,1,1978,5
charlotte zolotow,William's Doll (Jp 067),1985,5,5,4,1983,2
charlotte zolotow,Timothy Too!,1986,6,0,1,1985,1
charlotte zolotow,Early Sorrow: Ten Stories of Youth,1986,7,0,1,1986,0
charlotte zolotow,It's Not Fair (Ursula Nordstrom Book: Charlotte Zolot),1988,8,10,1,1986,2
charlotte zolotow,I Like to Be Little,1990,9,10,1,1988,2
charlotte zolotow,When the Wind Stops,1995,10,0,1,1990,5
charlotte zolotow,When the Wind Stops,1997,11,5,1,1995,2
chastity bono,"Family Outing : A Guide to the Coming-Out Process for Gays, Lesbians, &amp; Their Families",1999,2,8,1,1998,1
chastity bono,The End of Innocence: A Memoir,2002,3,0,3,1999,3
chastity bono,The End of Innocence : A Memoir,2003,4,8,1,2002,1
checkerbee publishing,Spring 1999 Collector's Value Guide To Ty Beanie Babies,1999,2,2,3,1998,1
checkerbee publishing,Boyds Plush Animals 2000 Collector's Value Guide,2000,3,0,1,1999,1
checkerbee publishing,Harry Potter Collector's Value Guide,2000,4,1.4285714285714286,7,2000,0
checkerbee publishing,Charming Tails 2000 Collector's Value Guide,2000,5,0,1,2000,0
checkerbee publishing,A Tribute to Dale Earnhardt Fan Guide,2001,6,10,1,2000,1
cheri fuller,Homelife: The Key to Your Child's Success in School,1991,2,0,1,1990,1
cheri fuller,Helping Your Child Succeed in Public School,1993,3,3,3,1991,2
cheri fuller,365 Ways to Build Your Child's Self Esteem,1994,4,8,1,1993,1
cheri fuller,Christmas Treasures of the Heart,1995,5,0,1,1994,1
cheri fuller,When Mothers Pray,1997,6,0,2,1995,2
cheri fuller,Quiet Whispers From God's Heart For Women,1999,7,0,1,1997,2
cheri fuller,When Mother's Pray,2001,8,0,2,1999,2
cheri fuller,When Teens Pray : Powerful Stories of How God Works,2002,9,0,1,2001,1
cheri k. erdman,Nothing to Lose: A Guide to Sane Living in a Larger Body,1996,2,0,1,1995,1
cherie burns,"Stepmotherhood: How to Survive Without Feeling Frustrated, Left Out, or Wicked",2001,2,9,1,1986,15
cherie calbom,The Juice Lady's Guide to Juicing for Health: Unleashing the Healing Power of Whole Fruits and Vegetables,1999,2,0,1,1992,7
cherie calbom,"The Ultimate Smoothie Book : 101 Delicious Recipes for Blender Drinks, Frozen Desserts, Shakes, and More!",2001,3,0,2,1999,2
cheryl st. john,"Land Of Dreams (Harlequin Historical, No 265)",1995,2,0.5714285714285714,14,1994,1
cheryl st. john,"Saint Or Sinner (Harlequin Historical, No 288)",1995,3,0,2,1995,0
cheryl st. john,"Badlands Bride (Harlequin Historical, 327)",1996,4,3.75,4,1995,1
cheryl st. john,"Truth About Toby (Harlequin Intimate Moments, No 810)",1997,5,0,4,1996,1
cheryl st. john,"Joe'S Wife (Harlequin Historical, No. 451)",1999,6,0,5,1997,2
cheryl st. john,"Doctor'S Wife (Harlequin Historical, No. 481)",1999,7,2,6,1999,0
cheryl st. john,Magnificent Seven (Montana Mavericks) (Montana Mavericks),2001,8,0,4,1999,2
cheryl st. john,"Sweet Annie (Harlequin Historical, 548)",2001,9,3.3333333333333335,3,2001,0
cheryl st. john,"Gunslinger'S Bride (Montana Mavericks) (Harlequin Historical Series, No. 577)",2001,10,0,6,2001,0
cheryl st. john,"Christmas Gold (Harlequin Historical, No. 627)",2002,11,2.25,4,2001,1
cheryl st. john,"Nick All Night (Silhouette Special Edition, 1475)",2002,12,1.1428571428571428,7,2002,0
cheryl st. john,"Marry Me ... Again   Montana Mavericks (Silhouette Special Edition, 1558)",2003,13,1,5,2002,1
cheryl st. john,"The Tenderfoot Bride (Harlequin Historical, 679)",2003,14,3.75,4,2003,0
cheryl willis hudson,Good Morning Baby (What-a-Baby Books),1992,2,0,1,1987,5
chilton,"Jeep Wagoner/Commando/Cherokee, 1957-83 (Chilton's Total Car Care Repair Manuals)",1997,2,7,1,1997,0
chilton,Honda Accord/Prelude 1996-00 (Chilton's Total Car Care Repair Manuals),2000,3,9,1,1997,3
chimo,Lila dice (Omnibus),1997,2,0,2,1996,1
chimo,La voz de Lila,2001,3,6,2,1997,4
chingiz aitmatov,The Place of the Skull,1989,2,0,4,1988,1
chip lovitt,Batman and the Ninja (Golden Look-Look Books),1995,2,0,1,1992,3
chip lovitt,Michael Jordan (Scholastic Biography),1995,3,0,1,1995,0
chip lovitt,The Ultimate Disney Joke Book,1995,4,0,1,1995,0
chip lovitt,SKATING FOR THE GOLD,1997,5,1.6111111111111112,18,1995,2
chip lovitt,Michael Jordan (Scholastic Biography),1998,6,0,3,1997,1
chip lovitt,American Gymnasts: Gold Medal Dreams,2000,7,0,1,1998,2
chocolate waters,Take Me Like a Photograph,1980,2,0,1,1980,0
chonda pierce,Chonda Pierce on Her Soapbox,1999,2,0,3,1998,1
chris horrocks,Introducing Baudrillard (Introducing...(Totem)),2001,2,3.5,2,1997,4
chris kubica,"The Book of FileMaker 6: Your One-Stop Guide to FileMaker Pro, Pro Unlimited, Developer, Server, and Mobile",2003,2,9,1,2002,1
chris madsen,A6 Dinosaur 3D,1999,2,9,1,1997,2
chris manby,"""\Girls' Night Out""""/\""""Boys' Night In\""""""""""",2001,2,3.7333333333333334,15,2000,1
chris manby,Sainsbury Lizzie Jordan Secret Life,2001,3,7,1,2001,0
chris manby,Wer einmal lÃ?Â¼gt. Das fantastische Leben der Lizzie Jordan.,2003,4,4,3,2001,2
chris manby,Running Away from Richard,2003,5,0,1,2003,0
chris manby,Getting Personal (Red Dress Ink),2004,6,4.2,5,2003,1
chris mckinney,The Queen of Tears,2001,2,0,1,1999,2
chris nickson,Superhero: A Biography of Christopher Reeve,1998,2,0,2,1995,3
chris nickson,Superhero: A Biography of Christopher Reeve,1999,3,0,1,1998,1
chris nickson,David Boreanaz : An Unauthorized Biography,1999,4,0,2,1999,0
chris nickson,"Ozzy Knows Best: The Amazing Story of Ozzy Osbourne, from Heavy Metal Madness to Father of the Year on MTV's \The Osbournes""""""""",2002,5,0.5,2,1999,3
chris rowthorn,Lonely Planet Japan (Lonely Planet Japan),2000,2,8,1,1999,1
chris rowthorn,"Lonely Planet South-East Asia on a Shoestring (Lonely Planet South-East Asia, 11th ed)",2001,3,4.5,2,2000,1
chris rowthorn,"Lonely Planet Malaysia, Singapore and Brunei (Lonely Planet Malaysia, Singapore and Brunei)",2001,4,8,1,2001,0
chris rowthorn,Lonely Planet Victoria (Lonely Planet Victoria),2002,5,5,2,2001,1
chris rowthorn,Lonely Planet Philippines (Lonely Planet Philippines),2003,6,0,1,2002,1
chris stewart,The Kill Box,1998,2,4,2,1997,1
chris stewart,Shattered Bone,1998,3,2,5,1998,0
chris stewart,Driving Over Lemons: An Optimist in Andalucia,2000,4,3.076923076923077,13,1998,2
chris stewart,The Kill Box,2000,5,0,6,2000,0
chris stewart,Driving over Lemons: An Optimist in Spain (Vintage Departures),2001,6,3.5925925925925926,27,2000,1
chris stewart,Unter den ZitronenbÃ?Â¤umen. Ein Optimist in Andalusien.,2003,7,7,1,2001,2
christian jacq,En Busca De Tutankamon,1995,2,9,1,1988,7
christian jacq,LA Piramide Asesinada,1995,3,7,1,1995,0
christian jacq,La Reine Soleil,1995,4,0,2,1995,0
christian jacq,Ramses: The Son of Light - Volume I (Vol 1),1997,5,3.5,20,1995,2
christian jacq,Das Gesetz der GÃ?Â¶tter.,1997,6,0,1,1997,0
christian jacq,The Ramses 2: the Temple of a Million Years (Ramses),1998,7,2.6363636363636362,11,1997,1
christian jacq,Ramses 2: The Temple of a Million Years (Ramses),1998,8,3.3333333333333335,3,1998,0
christian jacq,Ramses 3: The Battle of Kadesh (Ramses),1998,9,4,2,1998,0
christian jacq,Ramses 4: The Lady of Abu Simbel (Ramses),1998,10,3,2,1998,0
christian jacq,Ramses: The Battle of Kadesh - Volume III (Ramses),1998,11,8,3,1998,0
christian jacq,Ramses: The Lady of Abu Simbel - Volume IV (Vol 4),1998,12,3.4,5,1998,0
christian jacq,LA Piramide Asesinada,1998,13,6,1,1998,0
christian jacq,Ramses Volume II: The Eternal Temple,1998,14,2.8333333333333335,6,1998,0
christian jacq,Die letzten Tage von Philae.,1998,15,0,1,1998,0
christian jacq,"Le juge d'Egypte, tome 3 : La Justice du vizir",1999,16,4.6,5,1998,1
christian jacq,Ramses 1. Der Sohn des Lichts.,1999,17,1.1666666666666667,6,1999,0
christian jacq,Nofretete's Tochter.,1999,18,0.875,8,1999,0
christian jacq,Le Fils de La Lumiere (Ramses),1999,19,3,5,1999,0
christian jacq,"Ramses: Under the Western Acacia (Ramses Under the Western ACACIA, Vol. 5)",1999,20,2.4285714285714284,7,1999,0
christian jacq,The Black Pharaoh,1999,21,0.875,8,1999,0
christian jacq,La Bataille de Kadesh (Ramses),1999,22,3.5,2,1999,0
christian jacq,La Dame D'Abou Simbel (Ramses),1999,23,3.5,2,1999,0
christian jacq,"Ramses, tome 2 : Le Temple Des Millions D'Annees",1999,24,4,2,1999,0
christian jacq,"Le Juge d'Egypte, tome 1 : La Pyramide assassinÃ?Â©e",1999,25,4.8,5,1999,0
christian jacq,The Ramses 3: The Battle of Kadesh (Ramses),1999,26,0.8888888888888888,9,1999,0
christian jacq,Sous L'Acacia D'Occident (Ramses),1999,27,3.5,2,1999,0
christian jacq,The Ramses 4: The Lady of Abu Simbel,1999,28,1.3333333333333333,6,1999,0
christian jacq,"Le Juge d'Egypte, tome 2 : La Loi du dÃ?Â©sert",1999,29,0,5,1999,0
christian jacq,"Faraon Negro, El",1999,30,7,1,1999,0
christian jacq,The Black Pharaoh,1999,31,0,1,1999,0
christian jacq,Nefer the Silent,2000,32,5.181818181818182,11,1999,1
christian jacq,The Wise Woman (Stone of Light),2000,33,2.6363636363636362,11,2000,0
christian jacq,La mujer sabia,2000,34,2,3,2000,0
christian jacq,Lugar de verdad,2000,35,0,1,2000,0
christian jacq,El Enigma de La Piedra,2000,36,0,1,2000,0
christian jacq,Der schwarze Pharao.,2000,37,0,2,2000,0
christian jacq,The Black Pharaoh,2000,38,3.4,5,2000,0
christian jacq,"La Reine LibertÃ©, Tome 1: L'Empire des TÃ©nÃ¨bres",2001,39,0,1,2000,1
christian jacq,La Reine soleil,2001,40,8,1,2001,0
christian jacq,The Place of Truth (Stone of Light),2001,41,7.25,4,2001,0
christian jacq,Paneb the Ardent,2001,42,2.25,4,2001,0
christian jacq,Ramses 4. Die Herrin von Abu Simbel.,2001,43,0,1,2001,0
christian jacq,Stein des Lichts 1: Nefer der Schweigsame.,2001,44,6,2,2001,0
christian jacq,Bajo la Acacia de Occidente (Ramses),2002,45,0,1,2001,1
christian jacq,Stein des Lichts 2: Die weise Frau.,2002,46,7,1,2002,0
christian jacq,LA Reina Libertad 2: LA Guerra De Las Coronas,2002,47,0,1,2002,0
christian jacq,Im Bann des Pharaos. Roman.,2002,48,3.5,2,2002,0
christian jacq,El Imperio De Las Tinieblas. LA Reina Libertad I,2002,49,3.5,2,2002,0
christian jacq,El Juez De Egipto,2003,50,10,1,2002,1
christian jacq,The Flaming Sword (Queen of Freedom),2003,51,0,1,2003,0
christian jacq,"The Empire of Darkness : A Novel of Ancient Egypt (Jacq, Christian. Queen of Freedom Trilogy. Vol. 1.)",2003,52,0,1,2003,0
christian jacq,Stein des Lichts 4: Die StÃ?Â¤tte der Wahrheit.,2003,53,0,1,2003,0
christian jacq,"Piedra de La Luz 1, La - Nefer El Silencioso",2003,54,0,1,2003,0
christian jacq,LA Reina Sol,2003,55,7,1,2003,0
christian jacq,"La Reine LibertÃ?Â©, tome 2 : La Guerre des couronnes",2003,56,0,1,2003,0
christian jacq,War of the Crowns : A Novel of Ancient Egypt (Magnificent Queen  of Freedom Trilogy),2004,57,0,2,2003,1
christina kingston,The Night the Stars Fell,2001,2,3.75,4,2000,1
christina kingston,Ride the Winter Wind,2002,3,2.6666666666666665,3,2001,1
christina kingston,Ride the Wind Home,2003,4,4,2,2002,1
christina schwarz,Drowning Ruth (Oprah's Book Club),2001,2,3.8128342245989306,187,2000,1
christina schwarz,Drowning Ruth,2001,3,0,1,2001,0
christina schwarz,Novemberkind.,2001,4,6,1,2001,0
christina schwarz,Novemberkind.,2002,5,9,1,2001,1
christina schwarz,All Is Vanity : A Novel,2002,6,1.5,12,2002,0
christina schwarz,Drowning Ruth,2003,7,2.55,40,2002,1
christina schwarz,All Is Vanity (Ballantine Reader's Circle),2003,8,2.6666666666666665,15,2003,0
christine arnothy,I Am Fifteen--And I Don't Want to Die,1990,2,1.2,10,1986,4
christine arnothy,Complot de femmes,2001,3,7,1,1990,11
christine loomis,Fodor's Family Adventures: More Than 700 Great Trips for You and Your Kids of All Ages (Fodor's Family Adventures),2002,2,0,2,2000,2
christine wallace,Germaine Greer: Untamed Shrew,1999,2,5,1,1997,2
christoph,Emmitt Scholas: Flw,1997,2,0,1,1997,0
christoph,Zero Sldr Bkfr: Flw,1997,3,5,1,1997,0
christopher andersen,Young Kate,1988,2,0,1,1988,0
christopher andersen,Madonna: Unauthorized,1991,3,0,2,1988,3
christopher andersen,Young Kate,1992,4,0,1,1991,1
christopher andersen,Jagger Unauthorized,1993,5,0,1,1992,1
christopher andersen,Jagger Unauthorized,1994,6,3,2,1993,1
christopher andersen,Jagger Unauthorised,1994,7,0,1,1994,0
christopher andersen,MICHAEL JACKSON UNAUTHORIZED : MICHAEL JACKSON UNAUTHORIZED,1995,8,5,1,1994,1
christopher andersen,Jack and Jackie: Portrait of an American Marriage,1996,9,0.3333333333333333,3,1995,1
christopher andersen,An Affair to Remember: The Remarkable Love Story of Katharine Hepburn and Spencer Tracy,1997,10,2,3,1996,1
christopher andersen,Jack and Jackie: Portrait of an American Marriage,1997,11,0,1,1997,0
christopher andersen,The Day Diana Died,1998,12,4.428571428571429,7,1997,1
christopher andersen,Jackie After Jack: Portrait of the Lady,1998,13,0,1,1998,0
christopher andersen,"Affair to Remember, An : The Remarkable Love Story Of Katharine Hepburn And Spencer Tracy",1998,14,1.8333333333333333,6,1998,0
christopher andersen,The Day Diana Died,1999,15,9,1,1998,1
christopher andersen,Jackie After Jack : Portrait of the Lady,1999,16,9,2,1999,0
christopher andersen,The Day John Died,2000,17,2,3,1999,1
christopher andersen,The Day John Died,2001,18,0,6,2000,1
christopher andersen,Diana's Boys: William and Harry and the Mother They Loved,2001,19,5,2,2001,0
christopher andersen,George and Laura : Portrait of an American Marriage,2002,20,3.5,10,2001,1
christopher andersen,Diana's Boys : William and Harry and the Mother They Loved,2002,21,1.5,2,2002,0
christopher andersen,Sweet Caroline : Last Child of Camelot,2003,22,5,2,2002,1
christopher corbett,Orphans Preferred : The Twisted Truth and Lasting Legend of the Pony Express,2003,2,10,1,1986,17
christopher d. hartpence,Five Days in May,2002,2,0,1,2001,1
christopher de vinck,Simple Wonders,1995,2,0,1,1994,1
christopher fahy,Eternal Bliss,1988,2,0,2,1982,6
christopher hill,The English Bible and the Seventeenth-Century Revolution,1995,2,0,1,1991,4
christopher hill,Virtual Morality: A Novel,1999,3,0,1,1995,4
christopher lampton,Flights of Fantasy: Programming 3d Video Games in C++/Book and Disk,1993,2,7,1,1983,10
christopher lowell,"Christopher Lowell's If You Can Dream It, You Can Do It: Dream Decor on a Budget",2002,2,0,1,2000,2
christopher mcgowan,Discover Dinosaurs: A Royal Ontario Museum Book,1993,2,10,1,1992,1
christopher mcgowan,Make Your Own Dinosaur out of Chicken Bones : Foolproof Instructions for Budding Paleontologists,1997,3,0,1,1993,4
christopher mcgowan,The Dragon Seekers: How an Extraordinary Circle of Fossilists Discovered the Dinosaurs and Paved the Way for Darwin,2001,4,10,1,1997,4
christopher petit,Back from the Dead,2001,2,6,2,1998,3
christopher rice,A Density of Souls,2000,2,3.925925925925926,27,2000,0
christopher rice,A Density of Souls,2001,3,2.8292682926829267,41,2000,1
christopher rice,Independent Travellers New Zealand 2002: The Budget Travel Guide,2001,4,0,1,2001,0
christopher rice,Grausame Spiele.,2002,5,3.6666666666666665,3,2001,1
christopher rice,The Snow Garden: A Novel,2002,6,2.4285714285714284,21,2002,0
christopher rice,The Snow Garden : A Novel,2003,7,2.84,25,2002,1
christopher rice,The Snow Garden,2004,8,1.6666666666666667,21,2003,1
christopher sandford,Kurt Cobain,1996,2,0,1,1994,2
christopher sandford,Sting,1998,3,0,1,1996,2
christopher sandford,Bowie: Loving the Alien,1998,4,2.5,2,1998,0
christopher sandford,Springsteen: Point Blank,1999,5,7,1,1998,1
christopher sandford,Kurt Cobain,2001,6,2.5,2,1999,2
christopher sandford,McQueen,2002,7,0,3,2001,1
christopher sandford,McQueen: The Biography,2003,8,3,2,2002,1
christopher stringer,En Busca de Los Neandertales,2004,2,1,2,1997,7
christopher wallace,Resurrection Club,2000,2,0,1,1999,1
christopher wallace,The Pirate,2001,3,0,2,2000,1
christopher west,Death on Black Dragon River,1999,2,0,2,1998,1
christopher west,Journey to the Middle Kingdom,1999,3,8,1,1999,0
christos tsiolkas,Jump cuts,1996,2,0,1,1995,1
christy campbell,Fenian Fire: The British Government Plot to Assassinate Queen Victoria,2003,2,3,2,2002,1
christy lockhart,"Let'S Have A Baby  (Wed In The West) (Silhouette Desire, 1212)",1999,2,1.6666666666666667,3,1998,1
christy lockhart,"Cowboy'S Christmas Baby (Silhouette Desire, 1260)",1999,3,0,1,1999,0
christy lockhart,"One Snowbound Weekend... (Desire, 1314)",2000,4,0,1,1999,1
cindy garner,How Are Men Like Noodles II: The Ultimate Jokebook About Men,1995,2,0,1,1992,3
cindy garner,How Are Men Like Noodles: The Ultimate Joke Book About Men,1995,3,0,1,1995,0
cindy wheeler,Marmalade's Snowy Day,1982,2,10,1,1982,0
cindy wheeler,"Bookstore Cat  (Step into Reading, Step 1, paper)",1994,3,0,1,1982,12
cindy wheeler,Simple Signs (Picture Puffins),1997,4,0,1,1994,3
cizia zykã?â«,ParanoÃ?Â¯a,1990,2,9,1,1986,4
cizia zykã?â«,Tuan,1994,3,7,1,1990,4
claire bloom,Limelight and After,1983,2,0,1,1982,1
claire bretã?â©cher,"Agrippine, L'IntÃ?Â©grale",2000,2,4.5,2,1993,7
claire rayner,Soho Square: A novel,1976,2,0,1,1973,3
claire rayner,Paddington Green,1977,3,5,1,1976,1
claire rayner,Everything your doctor would tell you if he had the time,1980,4,5,2,1977,3
claire rayner,The Enduring Years,1983,5,0,1,1980,3
claire rayner,The Poppy Chronicles Volume 2: Flanders,1989,6,7,1,1983,6
claire rayner,Maddie,1990,7,0,1,1989,1
claire rayner,VIRUS MAN,1998,8,1,2,1990,8
claire rayner,How Did I Get Here from There?,2003,9,8,2,1998,5
claire sterling,The Time of the Assassins,1983,2,3,1,1981,2
claire sterling,The Terror Network,1987,3,0,1,1983,4
claire sterling,The Mafia,1991,4,7,1,1987,4
clare dowling,Expecting Emily (Export &amp; Airside),2003,2,0,1,2002,1
clare naylor,Catching Alice,2000,2,2.0714285714285716,14,1999,1
clare naylor,Dog Handling,2002,3,3.1132075471698113,53,2000,2
clare naylor,Dog Handling,2004,4,2.5,8,2002,2
clare naylor,The Second Assistant: a Tale from the Bottom of the Hollywood Ladder,2004,5,0,1,2004,0
clare turlay newberry,Mittens,1998,2,3,3,1998,0
clare turlay newberry,Smudge,1998,3,9,1,1998,0
claremont,Italian Phrase Book (Penguin Phrase Books),1999,2,0,1,1995,4
claremont,German Phrase Book (Penguin Phrase Books),1999,3,0,1,1999,0
clarissa pinkola estes,The Faithful Gardener,1995,2,0,1,1993,2
clarissa pinkola estes,Die Wolfsfrau. Die Kraft der weiblichen Urinstinkte.,1997,3,4.5,4,1995,2
clarissa pinkola estes,Die Wolfsfrau erzÃ?Â¤hlt. Auf den Spuren der Wilden Frau.,1998,4,0,1,1997,1
clarissa pinkola estes,Mujeres Que Corren Con Los Lobos,2000,5,0,1,1998,2
clarissa pinkola estes,Mujeres Que Corren Con Los Lobos - Bolsillo,2001,6,3.5,2,2000,1
claude izner,"Les EnquÃ?Âªtes de Victor Legris, tome 1 : MystÃ?Â¨re rue des Saint-PÃ?Â¨res",2003,2,3.5,2,2003,0
claude lanzmann,Shoah: An Oral History of the Holocaust : The Complete Text of the Film,1987,2,0,2,1985,2
claude lanzmann,Shoah,1997,3,8,1,1987,10
claude mckay,Harlem Glory: A Fragment of Aframerican Life,1988,2,0,1,1987,1
claude mckay,Selected Poems (Dover Thrift Editions),1999,3,3.3333333333333335,3,1988,11
claudine gandolfi,Little Christmas Treasures: The Traditions of Christmas,1997,2,0,1,1996,1
claudine gandolfi,Celtic Light: Wisdom &amp; Lore (Pocket Gift Editions),1998,3,0,1,1997,1
claudius seidl,"MÃ?Â¤nner essen Fleisch, Frauen essen GemÃ?Â¼se. 25 ungeklÃ?Â¤rte Fragen zwischen MÃ?Â¤nnern und Frauen.",2000,2,0,1,1995,5
clay coleman,"Mutiny! (Escape from Lost Island, No 3)",1991,2,0,1,1991,0
clay coleman,"Escape! (Escape from Lost Island, No 6)",1991,3,0,1,1991,0
clea simon,The Feline Mystique: On the Mysterious Connection Between Women and Cats,2002,2,3.5,2,1998,4
clifford chase,The Hurry-Up Song: A Memoir of Losing My Brother (Living Out),1999,2,0,2,1995,4
clifford stoll,Cuckoo's Egg,1990,2,0,1,1990,0
clifford stoll,Silicon Snake Oil: Second Thoughts on the Information Highway,1995,3,2.625,8,1990,5
clifford stoll,Silicon Snake Oil: Second Thoughts on the Information Highway,1996,4,2.875,8,1995,1
clifford stoll,Kuckucksei.,1998,5,4.5,2,1996,2
clifford stoll,Cuckoo's Egg: Tracking a Spy Through the Maze of Computer Espionage,2000,6,1.8,5,1998,2
clifford stoll,High Tech Heretic: Reflections of a Computer Contrarian,2000,7,10,1,2000,0
clifford stoll,LogOut.,2002,8,0,1,2000,2
clifton fadiman,The World Treasury of Children's Literature: Book 3 (World Treasury of Children's Literature),1985,2,10,1,1984,1
clifton fadiman,The World of the short story: A twentieth century collection,1986,3,4.5,2,1985,1
clifton fadiman,"The Little, Brown Book of Anecdotes",1991,4,6,2,1986,5
clifton fadiman,"The Treasury of the Encyclopaedia Britannica: More Then Two Centuries of Facts, Curiosities, and Discoveries from the Most Distinguished Reference W",1992,5,0,2,1991,1
clifton fadiman,The New Lifetime Reading Plan,1997,6,10,1,1992,5
clifton fadiman,"The New Lifetime Reading Plan : The Classical Guide to World Literature, Revised and Expanded",1999,7,5.4,5,1997,2
clint willis,High: Stories of Survival from Everest and K2 (Extreme Adventure),1999,2,1.6,5,1997,2
clint willis,Wild: Stories of Survival from the World's Most Dangerous Places (Adrenaline Books Series),1999,3,0,1,1999,0
clint willis,"Climb: Stories of Survival from Rock, Snow and Ice",1999,4,0,1,1999,0
clint willis,Rough Water: Stories of Survival from the Sea (Extreme Adventure),1999,5,0,2,1999,0
clint willis,"Dark: Stories of Madness, Murder and the Supernatural",2000,6,0,1,1999,1
clint willis,Storm: Stories of Survival From Land and Sea,2000,7,5,1,2000,0
clint willis,Adrenaline 2000: The Year's Best Stories of Adventure and Survival (Adrenaline),2000,8,0,1,2000,0
clint willis,Semper Fi: Stories of the United States Marines from Boot Camp to Battle,2003,9,2.3333333333333335,3,2000,3
clint willis,The I Hate Republicans Reader: Why the GOP is Totally Wrong About Everything,2003,10,3.3333333333333335,3,2003,0
clive cussler,Iceberg,1977,2,9,1,1977,0
clive cussler,Vixen 03,1978,3,2.25,4,1977,1
clive cussler,The Mediterranean Caper,1980,4,0,1,1978,2
clive cussler,Vixen 03,1981,5,1.5,4,1980,1
clive cussler,Night Probe,1981,6,8,2,1981,0
clive cussler,Night Probe,1982,7,1.4615384615384615,13,1981,1
clive cussler,Pacific Vortex,1982,8,2,7,1982,0
clive cussler,Raise the Titanic,1982,9,1.8,5,1982,0
clive cussler,Night Probe,1984,10,0,1,1982,2
clive cussler,Raise the Titanic,1984,11,0,2,1984,0
clive cussler,The Mediterranean Caper,1984,12,0,3,1984,0
clive cussler,Pacific Vortex,1984,13,0,1,1984,0
clive cussler,Iceberg,1984,14,3,4,1984,0
clive cussler,Vixen 03,1984,15,3.9473684210526314,19,1984,0
clive cussler,Pacific Vortex! (Dirk Pitt Adventures (Paperback)),1984,16,2.090909090909091,22,1984,0
clive cussler,Deep Six,1984,17,0,1,1984,0
clive cussler,Vixen 03,1984,18,0,2,1984,0
clive cussler,Pacific Vortex (G.K. Hall Large Print Book Series),1985,19,0,1,1984,1
clive cussler,DEEP 6,1985,20,2.7777777777777777,9,1985,0
clive cussler,CYCLOPS,1986,21,2.05,20,1985,1
clive cussler,CYCLOPS          X,1986,22,0,1,1986,0
clive cussler,Cyclops,1986,23,2.6666666666666665,3,1986,0
clive cussler,MEDITERR CAPER,1986,24,3,5,1986,0
clive cussler,Iceberg,1986,25,0,1,1986,0
clive cussler,Im Todesnebel. Roman.,1986,26,5,1,1986,0
clive cussler,DEEP 6,1987,27,0,2,1986,1
clive cussler,Cyclope,1988,28,0,1,1987,1
clive cussler,TREASURE-CUSSLER,1988,29,1,15,1988,0
clive cussler,MEDITERR CAPER,1988,30,0,1,1988,0
clive cussler,Iceberg,1988,31,3.75,4,1988,0
clive cussler,Treasure,1988,32,3.25,8,1988,0
clive cussler,Cyclops (Clive Cussler),1989,33,1.15,20,1988,1
clive cussler,Treasure (Clive Cussler),1989,34,2.2758620689655173,29,1989,0
clive cussler,DEEP SIX,1989,35,0,2,1989,0
clive cussler,Cyclop. Roman.,1990,36,6,1,1989,1
clive cussler,DEEP SIX,1990,37,1.0434782608695652,23,1990,0
clive cussler,Dragon,1990,38,1.8333333333333333,12,1990,0
clive cussler,RAISE THE TITANIC (Clive Cussler),1990,39,2.7777777777777777,27,1990,0
clive cussler,Mediterranean Caper,1991,40,1.7058823529411764,17,1990,1
clive cussler,ICEBERG : ICEBERG,1991,41,1.9047619047619047,21,1991,0
clive cussler,TrÃ?Â©sor,1991,42,0,1,1991,0
clive cussler,DRAGON,1991,43,2.020408163265306,49,1991,0
clive cussler,SAHARA (EXPORT),1992,44,0,1,1991,1
clive cussler,Sahara,1992,45,4,13,1992,0
clive cussler,Die Ajima - VerschwÃ?Â¶rung. Roman.,1993,46,2.5,2,1992,1
clive cussler,SAHARA,1993,47,2.026315789473684,38,1993,0
clive cussler,Operation Sahara.,1994,48,0,1,1993,1
clive cussler,INCA GOLD,1994,49,3.0952380952380953,21,1994,0
clive cussler,Night Probe!,1995,50,0.7272727272727273,22,1994,1
clive cussler,Inca Gold (Clive Cussler),1995,51,2.4927536231884058,69,1995,0
clive cussler,SAHARA,1995,52,1.8,25,1995,0
clive cussler,The Mediterranean Caper &amp; Iceberg,1995,53,0,1,1995,0
clive cussler,Shock Wave (Dirk Pitt Adventures (Paperback)),1996,54,2.1323529411764706,68,1995,1
clive cussler,MEDITERRANEAN CAPER,1996,55,4,2,1996,0
clive cussler,SHOCK WAVE (Dirk Pitt Adventures (Hardcover)),1996,56,3.56,25,1996,0
clive cussler,The SEA HUNTERS,1996,57,4,8,1996,0
clive cussler,Shockwave Mixed,1996,58,0,1,1996,0
clive cussler,FLOOD TIDE,1997,59,4,33,1996,1
clive cussler,Cyclops,1997,60,5,1,1997,0
clive cussler,Inka- Gold.,1997,61,0,1,1997,0
clive cussler,The SEA HUNTERS,1997,62,1.6153846153846154,39,1997,0
clive cussler,Inca Gold,1998,63,0.7777777777777778,9,1997,1
clive cussler,Shock Wave,1998,64,1,5,1998,0
clive cussler,Dirk Pitt Revealed,1998,65,2.25,8,1998,0
clive cussler,FLOOD TIDE,1998,66,1.7121212121212122,66,1998,0
clive cussler,Serpent From The Numa Files,1999,67,2.411764705882353,17,1998,1
clive cussler,Atlantis Found (Dirk Pitt Novels (Audio)),1999,68,3.5,4,1999,0
clive cussler,Dragon (Dirk Pitt Adventures (Paperback)),1999,69,0,1,1999,0
clive cussler,Atlantis Found (Dirk Pitt Adventures (Hardcover)),1999,70,4.615384615384615,39,1999,0
clive cussler,Vixen 03,1999,71,4,2,1999,0
clive cussler,El Imperio Del Agua/Flood Tide,2000,72,8,1,1999,1
clive cussler,Atlantis Found,2000,73,0,1,2000,0
clive cussler,The Numa Files 2: Blue Gold (NUMA Files),2000,74,7,1,2000,0
clive cussler,"Blue Gold : A Novel from the NUMA Files (Numa, No 2)",2000,75,4,2,2000,0
clive cussler,Blue Gold : A Novel from the NUMA Files,2000,76,2.1818181818181817,22,2000,0
clive cussler,Serpent : A Novel from the NUMA Files (Numa Files Series),2000,77,2.1923076923076925,52,2000,0
clive cussler,Numa Files 1: Serpent (Numa Files),2000,78,0,4,2000,0
clive cussler,Blue Gold : A Novel from the NUMA Files,2000,79,0,1,2000,0
clive cussler,Raise the Titanic!,2000,80,10,2,2000,0
clive cussler,Atlantis Found (Thorndike Large Print Basic Series),2000,81,4,2,2000,0
clive cussler,Iceberg (Dirk Pitt Adventures (Paperback)),2000,82,5,6,2000,0
clive cussler,Blue Gold : A Novel from the NUMA Files (NUMA Files (Paperback)),2001,83,1.7173913043478262,46,2000,1
clive cussler,Valhalla Rising (Dirk Pitt Adventures (Hardcover)),2001,84,2.710526315789474,38,2001,0
clive cussler,Inca Gold (Dirk Pitt Adventures (Paperback)),2001,85,0,3,2001,0
clive cussler,Serpiente,2001,86,6,1,2001,0
clive cussler,The NUMA Files 2: Blue Gold (A Novel from the NUMA Files),2001,87,0,3,2001,0
clive cussler,Treasure,2001,88,0,1,2001,0
clive cussler,Clive Cussler: Two Novels : Flood Tide; Cyclops,2001,89,0,1,2001,0
clive cussler,Valhalla Rising,2001,90,1,2,2001,0
clive cussler,Atlantis Found,2001,91,3.4038461538461537,104,2001,0
clive cussler,Das Alexandria- Komplott. Roman.,2001,92,7,1,2001,0
clive cussler,Valhalla Rising,2001,93,0,1,2001,0
clive cussler,Mayday !,2002,94,4,2,2001,1
clive cussler,Fire Ice: A Novel from the NUMA Files,2002,95,3.5,26,2002,0
clive cussler,Valhalla Rising (Dirk Pitt Adventures (Paperback)),2002,96,2.7523809523809524,105,2002,0
clive cussler,Fire Ice: A Novel from the Numa Files (Thorndike Press Large Print Basic Series),2002,97,6,1,2002,0
clive cussler,Eisberg.,2002,98,3.5,2,2002,0
clive cussler,Shock Wave (Dirk Pitt Adventures (Paperback)),2002,99,3.3333333333333335,3,2002,0
clive cussler,The Sea Hunters: More True Adventures With Famous Shipwrecks,2002,100,7,1,2002,0
clive cussler,Im Zeichen der Wikinger.,2002,101,3.5,2,2002,0
clive cussler,Hebt die Titanic. Roman.,2002,102,2.3333333333333335,3,2002,0
clive cussler,The Sea Hunters II,2002,103,1.3333333333333333,6,2002,0
clive cussler,Flood Tide,2003,104,4.833333333333333,6,2002,1
clive cussler,Akte Atlantis.,2003,105,0,1,2003,0
clive cussler,The Sea Hunters : True Adventures with Famous Shipwrecks,2003,106,1.7777777777777777,9,2003,0
clive cussler,Blue Gold : A Novel from the NUMA Files,2003,107,9,1,2003,0
clive cussler,Trojan Odyssey,2003,108,2.9130434782608696,23,2003,0
clive cussler,Cyclop. Roman.,2003,109,7,1,2003,0
clive cussler,Golden Buddha (Oregon Files (Paperback)),2003,110,4.041666666666667,24,2003,0
clive cussler,"Eisberg, der Todesflieger. Zwei Thriller in einem Band.",2003,111,7,1,2003,0
clive cussler,White Death: A Novel from the Numa Files,2003,112,3.357142857142857,14,2003,0
clive cussler,Fire Ice: A Novel from the Numa Files (Kurt Austin Adventures (Paperback)),2003,113,3,56,2003,0
clive cussler,The Sea Hunters II,2003,114,1.6,5,2003,0
clive cussler,Deep Six,2003,115,0,3,2003,0
clive cussler,The Mediterranean Caper,2004,116,2.4285714285714284,7,2003,1
clive cussler,Lost City,2004,117,3.5,2,2004,0
clive cussler,Iceberg,2004,118,0,5,2004,0
clive cussler,Raise the Titanic (Dirk Pitt Adventures (Paperback)),2004,119,4.111111111111111,9,2004,0
clive cussler,White Death (NUMA Files (Paperback)),2004,120,3.526315789473684,19,2004,0
clive cussler,Sacred Stone (Oregon Files (Paperback)),2004,121,10,1,2004,0
clive hart,Heaven and the Flesh : Imagery of Desire from the Renaissance to the Rococo,1995,2,0,1,1977,18
clive king,Story Library: Adventure Stories (Story Library),1993,2,7,1,1993,0
clive king,Stig of the Dump (Puffin Modern Classics),2002,3,7,1,1993,9
clive ponting,A Green History of the World: The Environment and the Collapse of Great Civilizations,1993,2,0,2,1987,6
clyde robert bulla,"Squanto, Friend of the Pilgrims",1954,2,0,1,1953,1
clyde robert bulla,The Sword in the Tree,1962,3,0,1,1954,8
clyde robert bulla,Shoeshine girl,1975,4,0,1,1962,13
clyde robert bulla,Conquista,1979,5,0,1,1975,4
clyde robert bulla,Daniel's Duck (I Can Read Book 3),1982,6,0,1,1979,3
clyde robert bulla,"Chalk Box Kid (Stepping Stone,  paper)",1987,7,0,1,1982,5
clyde robert bulla,Pocahontas and the Strangers,1988,8,0,3,1987,1
clyde robert bulla,Shoeshine Girl (Trophy Chapter Books (Paperback)),1989,9,0,1,1988,1
clyde robert bulla,Squanto: Friend of Pilgrims,1989,10,0,1,1989,0
clyde robert bulla,"Singing Sam (Step into Reading, Step 3, paper)",1989,11,0,1,1989,0
clyde robert bulla,"Squanto, Friend of the Pilgrims (Scholastic Biography)",1990,12,3,3,1989,1
clyde robert bulla,The Ghost of Windy Hill,1990,13,4,2,1990,0
clyde robert bulla,Three Dollar Mule,1995,14,0,2,1990,5
clyde robert bulla,Pocahontas and the Strangers,1995,15,0,1,1995,0
clyde robert bulla,The Valentine Cat,1995,16,0,1,1995,0
clyde robert bulla,The Sword in the Tree (Trophy Chapter Book),2000,17,0,1,1995,5
coerte v. w. felske,Word,2000,2,1.1428571428571428,7,1999,1
coerte v. w. felske,The Millennium Girl,2000,3,0,10,2000,0
coerte v. w. felske,Millennium Girl,2000,4,0,1,2000,0
colby rodowsky,P.S.Write Soon,1980,2,0,1,1978,2
colby rodowsky,Hannah in Between,1996,3,0,2,1980,16
colby rodowsky,Remembering Mog (An Avon Flare Book),1998,4,0,3,1996,2
colby rodowsky,The Turnabout Shop,2000,5,0,1,1998,2
cole thompson,Chocolate Lizards: A Novel,2000,2,0,2,1999,1
colin bateman,Of wee sweetie mice and men,1996,2,9,1,1996,0
colin bateman,Cycle of Violence,1996,3,0,1,1996,0
colin bateman,Cycle of Violence,1997,4,2.2,5,1996,1
colin bateman,Of Wee Sweetie Mice and Men,1997,5,0,1,1997,0
colin bateman,Maid of the Mist,1999,6,0,1,1997,2
colin bateman,Turbulent Priests,2000,7,9,1,1999,1
colin bateman,Mohammed Maguire,2001,8,0,3,2000,1
colin bateman,Murphy's Law,2002,9,3,1,2001,1
colin cheong,Seventeen,1996,2,6,1,1991,5
colin dexter,The Riddle of the Third Mile,1988,2,3.3,10,1988,0
colin dexter,Service of All the Dead,1988,3,7,2,1988,0
colin dexter,Last Bus To Woodstock,1988,4,0,4,1988,0
colin dexter,"DEAD OF JERICHO, THE",1988,5,4.166666666666667,6,1988,0
colin dexter,Last Seen Wearing,1988,6,2.5,6,1988,0
colin dexter,"SECRET OF ANNEXE 3, THE",1988,7,2.8333333333333335,6,1988,0
colin dexter,The second Inspector Morse omnibus,1991,8,0,3,1988,3
colin dexter,The Wench Is Dead,1991,9,3.6,5,1991,0
colin dexter,The Jewel That Was Ours (An Inspector Morse Mystery),1992,10,7,1,1991,1
colin dexter,The Jewel That Was Ours,1993,11,2.142857142857143,7,1992,1
colin dexter,Finstere GrÃ?Â¼nde.,1993,12,3.3333333333333335,3,1993,0
colin dexter,Morse's Greatest Mystery and Other Stories,1993,13,0,1,1993,0
colin dexter,The Way Through the Woods,1994,14,1.7058823529411764,17,1993,1
colin dexter,"The First Inspector Morse Omnibus: The Dead of Jericho, Service of All the Dead, the Silent World of Nicholas Quinn",1995,15,3.2,5,1994,1
colin dexter,The Daughters of Cain,1995,16,5.277777777777778,18,1995,0
colin dexter,Morse's Greatest Mystery: And Other Stories,1995,17,2.3333333333333335,3,1995,0
colin dexter,The Daughters of Cain,1995,18,0,1,1995,0
colin dexter,Morse's Greatest Mystery and Other Stories (Inspector Morse Mysteries (Paperback)),1996,19,3.6,5,1995,1
colin dexter,The Daughters of Cain,1996,20,2.5833333333333335,12,1996,0
colin dexter,Service of All the Dead,1996,21,1.3333333333333333,6,1996,0
colin dexter,Last Bus to Woodstock,1996,22,2.375,8,1996,0
colin dexter,Last Seen Wearing,1997,23,3,8,1996,1
colin dexter,Death Is Now My Neighbor: An Inspector Morse Novel,1997,24,0,4,1997,0
colin dexter,The Dead of Jericho (Inspector Morse Mysteries (Paperback)),1997,25,1.2857142857142858,7,1997,0
colin dexter,Silent World of Nicholas Quinn (Inspector Morse Mysteries (Paperback)),1997,26,0,3,1997,0
colin dexter,Death Is Now My Neighbor: A Mystery (Random House Large Print),1997,27,0,1,1997,0
colin dexter,Death Is Now My Neighbour,1997,28,3.210526315789474,19,1997,0
colin dexter,The Riddle of the Third Mile (Inspector Morse Mysteries (Paperback)),1997,29,0,2,1997,0
colin dexter,The Secret of Annexe 3 (Inspector Morse Mysteries (Paperback)),1998,30,2.5,12,1997,1
colin dexter,Death Is Now My Neighbor,1998,31,2.6666666666666665,3,1998,0
colin dexter,The Wench Is Dead (Inspector Morse Mysteries (Paperback)),1999,32,3.5,4,1998,1
colin dexter,The Remorseful Day (Inspector Morse Mysteries (Hardcover)),2000,33,3.2,5,1999,1
colin dexter,The Remorseful Day,2001,34,3,11,2000,1
colin dexter,Morse's Greatest Mystery,2003,35,0,1,2001,2
colin mcevedy,Penguin Atlas of Ancient History (Reference Books),1986,2,0,1,1985,1
colin mcevedy,The New Penguin Atlas of Medieval History,1992,3,7,1,1986,6
colin turnbull,The Forest People (Touchstone Book),1987,2,3.125,8,1987,0
colleen o'shaughnessy mckenna,Murphy's Island,1991,2,0,1,1991,0
colleen o'shaughnessy mckenna,The Truth About Sixth Grade,1992,3,5.5,2,1991,1
colleen o'shaughnessy mckenna,Too Many Murphys,1992,4,0,4,1992,0
colleen o'shaughnessy mckenna,Cousins: Not Quite Sisters,1993,5,8,2,1992,1
colleen o'shaughnessy mckenna,Mother Murphy,1993,6,0,2,1993,0
colleen o'shaughnessy mckenna,Cousins: Stuck in the Middle,1993,7,0,1,1993,0
colleen o'shaughnessy mckenna,Camp Murphy,1993,8,0,1,1993,0
colleen o'shaughnessy mckenna,Good Grief...Third Grade,1994,9,3,4,1993,1
colleen o'shaughnessy mckenna,Camp Murphy,1994,10,0,1,1994,0
colleen o'shaughnessy mckenna,"New Friends (Dr. Quinn Medicine, Woman, No 1)",1995,11,5,1,1994,1
colleen o'shaughnessy mckenna,Valentine's Day Can Be Murder,1997,12,0,3,1995,2
colleen o'shaughnessy mckenna,Fifth Grade: Here Comes Trouble,1997,13,0,1,1997,0
colleen quinn,Outlaws Angel (Heartfire Romance),1988,2,0,1,1987,1
colleen quinn,Colorado Flame,1989,3,4,2,1988,1
colleen quinn,Defiant Rose,1992,4,0,1,1989,3
colleen quinn,Unveiled,1993,5,9,1,1992,1
collette,Gigi and the Cat (Isis Large Print Fiction),1987,2,7,1,1969,18
connie briscoe,Sisters &amp; Lovers,1995,2,0.5833333333333334,12,1994,1
connie briscoe,Big Girls Don't Cry,1996,3,0,1,1995,1
connie briscoe,Sisters &amp; Lovers,1996,4,0,1,1996,0
connie briscoe,Big Girls Don't Cry,1997,5,0,2,1996,1
connie briscoe,A Long Way from Home,1999,6,0,3,1997,2
connie briscoe,Big Girls Don't Cry (One World Fawcett Gold Medal Bk),1999,7,8,1,1999,0
connie briscoe,A Long Way from Home,2000,8,0,2,1999,1
connie briscoe,P. G. County,2002,9,4.714285714285714,7,2000,2
connie rose porter,High Hopes for Addy (American Girls Short Stories),1999,2,5,2,1991,8
connie rose porter,Addy's Little Brother (The American Girls Collection),2000,3,10,1,1999,1
connie rose porter,Imani All Mine,2000,4,0,1,2000,0
conrad richter,The Lady,1985,2,0,1,1983,2
conrad richter,The Trees,1991,3,1.6666666666666667,3,1985,6
conrad richter,The Town,1991,4,0,2,1991,0
conrad richter,The Fields,1991,5,4,2,1991,0
conrad richter,The Light in the Forest,1995,6,1.588235294117647,17,1991,4
cook,Pears Cyclopaedia,1999,2,4,2,1999,0
cor van den heuvel,The Haiku Anthology,2000,2,5.666666666666667,3,1999,1
corby kummer,"The Joy of Coffee: The Essential Guide to Buying, Brewing and Enjoying",1997,2,0,1,1995,2
corby kummer,"The Pleasures of Slow Food: Celebrating Authentic Traditions, Flavors, and Recipes",2002,3,10,1,1997,5
cordia byers,Ryan's Gold,1988,2,0,1,1986,2
cordia byers,Eden,1992,3,7,1,1988,4
cordia byers,Lady of the Night (Timeswept),1998,4,0,3,1992,6
cormac mccarthy,Suttree (Vintage Contemporaries),1992,2,3,7,1986,6
cormac mccarthy,"All the Pretty Horses (Border Trilogy, Vol 1)",1992,3,2.78125,32,1992,0
cormac mccarthy,"Blood Meridian, Or, the Evening Redness in the West",1992,4,3.347826086956522,23,1992,0
cormac mccarthy,"All the Pretty Horses (The Border Trilogy, Vol 1)",1993,5,2.2312925170068025,147,1992,1
cormac mccarthy,Child of God (Vintage International),1993,6,2.5714285714285716,7,1993,0
cormac mccarthy,Outer Dark,1993,7,3.1666666666666665,6,1993,0
cormac mccarthy,All the Pretty Horses (Border Trilogy (Hardcover)),1993,8,7,1,1993,0
cormac mccarthy,The Orchard Keeper,1993,9,3.4,5,1993,0
cormac mccarthy,The Crossing (Random House Large Print),1994,10,3,2,1993,1
cormac mccarthy,"The Crossing (Border Trilogy, Vol 2)",1994,11,3.642857142857143,14,1994,0
cormac mccarthy,Verlorene.,1994,12,0,1,1994,0
cormac mccarthy,"The Crossing (The Border Trilogy, V. 2)",1995,13,3.1333333333333333,15,1994,1
cormac mccarthy,GrenzgÃ?Â¤nger.,1997,14,0,1,1995,2
cormac mccarthy,"Cities of the Plain : A Novel (Border Trilogy, V. 3.)",1998,15,4.230769230769231,13,1997,1
cormac mccarthy,Suttree,1998,16,0,1,1998,0
cormac mccarthy,Cities of the Plain (Border Trilogy (Paperback)),1999,17,2.3333333333333335,3,1998,1
cormac mccarthy,All The Pretty Horses,2000,18,0,2,1999,1
cormac mccarthy,All The Pretty Horses CD,2000,19,0,1,2000,0
cormac mccarthy,Blood Meridian : Or the Evening Redness in the West (Modern Library),2001,20,5,1,2000,1
cormac mccarthy,Suttree (Modern Library),2002,21,5,1,2001,1
cory daniells,"Dark Dreams (Daniells, Cory. Last T'en Trilogy.)",2001,2,3,5,1999,2
cory daniells,"Desperate Alliances (The Last T'en Trilogy, Book 3)",2002,3,9,1,2001,1
cory doctorow,Down and Out in the Magic Kingdom,2003,2,5.5,8,2003,0
cory doctorow,A Place So Foreign and Eight More,2003,3,0,2,2003,0
cory doctorow,Eastern Standard Tribe,2004,4,2.3333333333333335,6,2003,1
craig shaw gardner,"Wishbringer (Infocom, No 2)",1988,2,1.75,4,1987,1
craig shaw gardner,"Back to the Future, Part 2: A Novel",1989,3,3.2,5,1988,1
craig shaw gardner,Batman: The Novelization,1989,4,1.9285714285714286,14,1989,0
craig shaw gardner,A Multitude of Monsters,1989,5,0,1,1989,0
craig shaw gardner,Slaves of the Volcano God,1989,6,4,6,1989,0
craig shaw gardner,The Batman Murders,1990,7,2.8,5,1989,1
craig shaw gardner,Cineverse Cycle Omnibus,1992,8,0,1,1990,2
craig shaw gardner,Batman Returns,1992,9,0,1,1992,0
craig shaw gardner,Batman Returns: The Novelization,1992,10,0,3,1992,0
craig shaw gardner,"Revenge of the Fluffy Bunnies (Cineverse Cycle, No 3)",1992,11,0,1,1992,0
craig shaw gardner,Dragon Sleeping,1995,12,0,1,1992,3
craig shaw gardner,The Bride of Slime Monster (Cineverse Cycle),1995,13,0,1,1995,0
craig shaw gardner,Dragon Burning (Dragon Circle),1997,14,0,1,1995,2
craig shaw gardner,Return to Chaos (Buffy the Vampire Slayer),1998,15,1.826086956521739,23,1997,1
craig shaw gardner,Leprechauns (Hallmark Entertainment Books),1999,16,2.9166666666666665,12,1998,1
craig shaw gardner,An Excess of Enchantments,2003,17,0,2,1999,4
craig shaw gardner,A Disagreement With Death,2003,18,5,1,2003,0
craig stinson,Running Microsoft Windows Nt Workstation: Version 4.0,1996,2,0,1,1995,1
cristina peri rossi,El Amor Es Una Droga Dura,2000,2,0,1,1996,4
crystal stovall,"Groom Worth Waithing For (Love Inspired, November 01)",2001,2,3.3333333333333335,6,1997,4
crystal stovall,Gifts Of Love (Love Inspired),2002,3,5,4,2001,1
curtis pesmen,Your First Year of Marriage,1995,2,0,2,1992,3
cyndi lee,Om Yoga Flash Cards (Om Yoga),2002,2,5,1,2002,0
cyndi lee,OM at Home,2003,3,0,1,2002,1
cynthia copeland lewis,Dilly's Big Sister Diary,1998,2,8,1,1994,4
cynthia crossen,Tainted Truth : The Manipulation of Fact In America,1996,2,0,1,1994,2
cynthia heald,Becoming a Woman of Freedom,1992,2,1.2,5,1986,6
cynthia heald,Becoming a Woman of Purpose: A Bible Study,1994,3,0,2,1992,2
cynthia heald,Becoming a Woman of Prayer: A Bible Study,1996,4,0,3,1994,2
cynthia heald,A Journal for the Journey: The Companion to a Woman's Journey to the Heart of God,1997,5,0,1,1996,1
cynthia heald,A Woman's Journey to the Heart of God,1997,6,0,2,1997,0
cynthia heald,When The Father Holds You Close: A Journey to Deeper Intimacy with God,1999,7,0,1,1997,2
cynthia johnson,What Smart Girls Know About the SAT: How to Beat the Gender Bias,2003,2,0,1,2001,2
cynthia sternau,The Secret Prophecies of Nostradamus,1997,2,4,1,1995,2
cynthia wright,Silver Storm,1981,2,0,1,1977,4
cynthia wright,Spring Fires,1983,3,0,1,1981,2
cynthia wright,"You, and No Other",1984,4,0,1,1983,1
cynthia wright,Battle for Love,1986,5,3.5,2,1984,2
cynthia wright,Surrender the Stars,1987,6,0,2,1986,1
cynthia wright,Brighter Than Gold,1990,7,0,2,1987,3
cynthia wright,Fireblossom,1992,8,0,1,1990,2
cynthia wright,Wildblossom,1994,9,3.75,4,1992,2
czeslaw milosz,Emperor of the Earth,1981,2,0,1,1981,0
czeslaw milosz,The Issa Valley,1982,3,0,1,1981,1
czeslaw milosz,Witness of Poetry (Charles Eliot Norton Lectures),1984,4,8,1,1982,2
czeslaw milosz,The History of Polish Literature,1984,5,8,1,1984,0
czeslaw milosz,Land of Ulro,1985,6,9,1,1984,1
czeslaw milosz,Unattainable Earth,1987,7,0,1,1985,2
czeslaw milosz,The Captive Mind,1990,8,0,1,1987,3
czeslaw milosz,Bells in Winter,1996,9,0,1,1990,6
czeslaw milosz,A Roadside Dog,1998,10,7,1,1996,2
czeslaw milosz,A Book of Luminous Things: An International Anthology of Poetry,1998,11,7,5,1998,0
d. b. c. pierre,Vernon God Little: A 21st Century Comedy in the Presence of Death,2003,2,2.85,20,2003,0
d. e. athkins,Secret Santa,2001,2,0,4,1996,5
d.j. conway,Animal Magick: The Art of Recognizing &amp; Working With Familiars,1995,2,4.75,4,1995,0
d.j. conway,"By Oak, Ash &amp; Thorn: Modern Celtic Shamanism (Llewellyn's Celtic Wisdom)",1995,3,4.5,2,1995,0
d.r. sherman,Old Mali and the Boy,1966,2,7,1,1966,0
dalai lama xiv bstan-'dzin-rgya-mtsho,Transforming the Mind,2000,2,5,3,1990,10
dalai lama xiv bstan-'dzin-rgya-mtsho,The Good Heart,2002,3,6,1,2000,2
dale evans rogers,God in the Hard Times,1984,2,2.6666666666666665,3,1983,1
dale evans rogers,Angel Unaware,1992,3,8,2,1984,8
damien broderick,The dark between the stars: Speculative fiction,1991,2,4,1,1984,7
damien broderick,The White Abacus,1997,3,0,3,1991,6
damien broderick,The White Abacus,1997,4,0,1,1997,0
damien broderick,White Abacus,1998,5,2.5,2,1997,1
damien broderick,Not the Only Planet: Science Fiction Travel Stories,1998,6,8,1,1998,0
damien broderick,The Last Mortal Generation: How Science Will Alter Our Lives in the 21st Century,2000,7,0,1,1998,2
damien broderick,The Spike: How Our Lives Are Being Transformed by Rapidly Advancing Technologies,2001,8,0,2,2000,1
damien broderick,Transcension,2002,9,3,3,2001,1
damion hunter,Barbarian Princess (Centurions Series Book II),1982,2,0,2,1981,1
damon runyon,The Racing World of Damon Runyon,1999,2,0,1,1981,18
dan elish,Born Too Short : The Confessions of an Eighth-Grade Basket Case,2003,2,0,2,1992,11
dan reynolds,"Highwayman (Harlequin Regency Romance, 109)",1993,2,0,1,1989,4
dan shapiro,LA Marihuana De Mama,2002,2,0,1,2001,1
dan yashinsky,Ghostwise: A Book of Midnight Stories,1997,2,0,3,1992,5
dana corbit,An Honest Life (Love Inspired),2003,2,0.7142857142857143,14,2002,1
dana shilling,William E. Donoghue's Lifetime Financial Planner: Straight Talk about Your Money Decisions,1988,2,0,1,1988,0
dana shilling,"Real Life, Real Answers: Earning, Saving, Investing, Enjoying, a Realistic Guide to Managing Your Money",1988,3,0,2,1988,0
dana shilling,The Business of Business,1989,4,7,1,1988,1
danette chartier,Alabama Twilight (Magnolia Road),1993,2,0,1,1993,0
danette chartier,Midnight Promises (A Zebra Heartfire Historical Romance),1994,3,0,1,1993,1
dani cavallaro,"The Gothic Vision: Three Centuries of Horror, Terror and Fear",2002,2,7,1,2000,2
daniel carney,Macau,1986,2,0,3,1978,8
daniel clowes,David Boring,2000,2,0,1,1998,2
daniel clowes,Ghost World,2001,3,3.8,20,2000,1
daniel clowes,David Boring,2002,4,4.666666666666667,3,2001,1
daniel clowes,Twentieth Century Eightball (20th Century Eightball),2002,5,7,1,2002,0
daniel clowes,Caricature,2002,6,9,1,2002,0
daniel horch,The Angel with One Hundred Wings : A Tale from the Arabian Nights,2004,2,2.5,2,2002,2
daniel manus pinkwater,The Magic Moscow,1980,2,0,1,1976,4
daniel manus pinkwater,Moosepire,1986,3,0,1,1980,6
daniel manus pinkwater,LIZARD MUSIC,1988,4,2,5,1986,2
daniel manus pinkwater,"Fish Whistle: Commentaries, Uncommentaries, and Vulgar Excesses",1989,5,7,1,1988,1
daniel manus pinkwater,Lizard Music,1996,6,6,3,1989,7
daniel manus pinkwater,The Education of Robert Nifkin,1998,7,0,1,1996,2
daniel manus pinkwater,"Superpuppy: How to Choose, Raise, and Train the Best Possible Dog for You (How to Choose, Raise, and Train the Best Possible Dog for You)",2002,8,8,1,1998,4
daniel ogden,"Magic, Witchcraft, and Ghosts in the Greek and Roman Worlds: A Sourcebook",2002,2,0,1,2001,1
daniel pollock,Pursuit into Darkness,1994,2,0,1,1990,4
daniel pollock,Precipice,1997,3,0,1,1994,3
daniel schorr,Staying Tuned : A Life in Journalism,2001,2,0,3,1977,24
daniele del giudice,Atlante occidentale,1985,2,8,1,1983,2
daniele del giudice,Lines of Light,1988,3,0,1,1985,3
daniele del giudice,Takeoff: The Pilot's Lore,1997,4,4,2,1988,9
daniele del giudice,Mania,1997,5,0,1,1997,0
daniella burr,Don't Just Sit There!: 50 Ways to Have a Nickelodeon Day (Nickelodeon),1992,2,6,1,1992,0
daniella burr,The Bailey School Kids Joke Book,1997,3,0,1,1992,5
danielle steel,The Promise,1978,2,1.9230769230769231,52,1977,1
danielle steel,Now and Forever,1978,3,1.3833333333333333,60,1978,0
danielle steel,Season of Passion,1980,4,1.851063829787234,47,1978,2
danielle steel,Summer's End,1980,5,2.029850746268657,67,1980,0
danielle steel,Loving,1980,6,0,2,1980,0
danielle steel,Palomino,1981,7,5.25,4,1980,1
danielle steel,Loving,1981,8,2.0256410256410255,39,1981,0
danielle steel,To Love Again,1981,9,2.0238095238095237,42,1981,0
danielle steel,The Ring,1981,10,1.4,5,1981,0
danielle steel,Love .....poems by Danielle Steel,1981,11,0,1,1981,0
danielle steel,Perfect Stranger,1982,12,1.9285714285714286,14,1981,1
danielle steel,Remembrance,1983,13,2.282608695652174,46,1982,1
danielle steel,Ahora Y Para Siempre/Now and Forever,1983,14,6,1,1983,0
danielle steel,Changes,1983,15,0,4,1983,0
danielle steel,Once in a Lifetime,1983,16,1.9,60,1983,0
danielle steel,The Ring,1983,17,1.4705882352941178,51,1983,0
danielle steel,Once in a Lifetime,1983,18,0.8333333333333334,6,1983,0
danielle steel,A Perfect Stranger,1983,19,2.423076923076923,52,1983,0
danielle steel,Thurston House,1983,20,1.25,12,1983,0
danielle steel,Love: Poems,1984,21,1.8,5,1983,1
danielle steel,The Ring,1984,22,6,1,1984,0
danielle steel,Full Circle,1984,23,2.8333333333333335,6,1984,0
danielle steel,Die Liebe eines Sommers. Roman.,1984,24,0,1,1984,0
danielle steel,Alle Liebe dieser Erde. Roman.,1984,25,8,1,1984,0
danielle steel,Thurston House,1984,26,1.676923076923077,65,1984,0
danielle steel,Changes,1984,27,1.9863013698630136,73,1984,0
danielle steel,Palomino,1985,28,1.6721311475409837,61,1984,1
danielle steel,Full Circle,1985,29,1.6875,48,1985,0
danielle steel,Secrets,1985,30,4.2,5,1985,0
danielle steel,GOING HOME,1985,31,0,4,1985,0
danielle steel,Family Album,1985,32,0,9,1985,0
danielle steel,Secrets,1986,33,1.6808510638297873,94,1985,1
danielle steel,Wanderlust,1986,34,1.8333333333333333,12,1986,0
danielle steel,Wanderlust,1987,35,1.7179487179487178,78,1986,1
danielle steel,Crossings,1987,36,1.736842105263158,76,1987,0
danielle steel,Fine Things,1987,37,0,5,1987,0
danielle steel,Kaleidoscope,1987,38,0.2777777777777778,18,1987,0
danielle steel,Unter dem Regenbogen. Roman.,1987,39,4,2,1987,0
danielle steel,GOING HOME,1988,40,3.3333333333333335,6,1987,1
danielle steel,Kaleidoscope,1988,41,1.7126436781609196,87,1988,0
danielle steel,Fine Things,1988,42,1.8461538461538463,91,1988,0
danielle steel,Une autre vie,1988,43,0,1,1988,0
danielle steel,Zoya,1988,44,2.8823529411764706,17,1988,0
danielle steel,Zoya,1989,45,1.186046511627907,86,1988,1
danielle steel,Family Album,1989,46,1.178082191780822,73,1989,0
danielle steel,Love,1989,47,3.25,8,1989,0
danielle steel,Daddy,1989,48,1.8275862068965518,29,1989,0
danielle steel,Star,1989,49,2.6,15,1989,0
danielle steel,Message from Nam (Limited Edition),1990,50,4,1,1989,1
danielle steel,Das Haus hinter dem Wind. Roman.,1990,51,0,1,1990,0
danielle steel,Star,1990,52,1.4814814814814814,54,1990,0
danielle steel,Danielle Steel: Kaleidoscope/Star/Fine Things,1990,53,0,1,1990,0
danielle steel,Message from Nam,1990,54,2.2666666666666666,15,1990,0
danielle steel,Daddy,1990,55,1.6823529411764706,85,1990,0
danielle steel,GOING HOME,1990,56,5,3,1990,0
danielle steel,Message from 'Nam (Bantam/Doubleday/Delacorte Press Large Print Collection),1990,57,0,1,1990,0
danielle steel,Going Home,1991,58,1.6333333333333333,60,1990,1
danielle steel,No Greater Love (Delacorte Pr Large Print Edition),1991,59,0,1,1991,0
danielle steel,No Greater Love,1991,60,1.3043478260869565,23,1991,0
danielle steel,TÃ?Â¶chter der Sehnsucht. Roman.,1991,61,2,2,1991,0
danielle steel,Heartbeat,1991,62,2.45,20,1991,0
danielle steel,Message from Nam,1991,63,1.9577464788732395,71,1991,0
danielle steel,Mixed Blessings,1992,64,1.2272727272727273,22,1991,1
danielle steel,Heartbeat,1992,65,1.5316455696202531,79,1992,0
danielle steel,Jewels,1992,66,2.391304347826087,23,1992,0
danielle steel,No Greater Love,1992,67,2.539473684210526,76,1992,0
danielle steel,Jewels,1993,68,1.3269230769230769,52,1992,1
danielle steel,Vanished,1993,69,4,2,1993,0
danielle steel,Mixed Blessings,1993,70,1.6557377049180328,61,1993,0
danielle steel,Vanished,1993,71,2.533333333333333,30,1993,0
danielle steel,El Regalo,1994,72,5,1,1993,1
danielle steel,Passion's Promise,1994,73,10,1,1994,0
danielle steel,Wings,1994,74,1.542857142857143,35,1994,0
danielle steel,The Gift,1994,75,3.245614035087719,57,1994,0
danielle steel,Una Cruel Bendicion,1994,76,5,1,1994,0
danielle steel,La promesa,1994,77,5,1,1994,0
danielle steel,Wings,1994,78,0,1,1994,0
danielle steel,Souvenirs du Vietnam,1994,79,0,2,1994,0
danielle steel,Vanished,1994,80,2.014705882352941,68,1994,0
danielle steel,Accident,1994,81,2.306122448979592,49,1994,0
danielle steel,Sternenfeuer. Roman.,1994,82,0,1,1994,0
danielle steel,The Gift,1994,83,9,1,1994,0
danielle steel,Wings,1995,84,2.693877551020408,49,1994,1
danielle steel,Five Days in Paris,1995,85,0,4,1995,0
danielle steel,Lightning,1995,86,3.3043478260869565,23,1995,0
danielle steel,Five Days in Paris,1995,87,3,47,1995,0
danielle steel,Volar,1995,88,0,1,1995,0
danielle steel,Nachricht aus der Ferne. Roman.,1995,89,5,1,1995,0
danielle steel,Accident,1995,90,2.6973684210526314,76,1995,0
danielle steel,Silent Honor,1996,91,0,1,1995,1
danielle steel,Five Days in Paris,1996,92,0,1,1996,0
danielle steel,Lightning,1996,93,1.4426229508196722,61,1996,0
danielle steel,The Gift,1996,94,2.411764705882353,85,1996,0
danielle steel,Silent Honor,1996,95,2.0833333333333335,36,1996,0
danielle steel,Silent Honor,1996,96,7,1,1996,0
danielle steel,Malice,1996,97,2.8333333333333335,36,1996,0
danielle steel,Cinco dÃ­as en ParÃ­s,1996,98,7,1,1996,0
danielle steel,The Ghost,1997,99,4,4,1996,1
danielle steel,The Ranch,1997,100,1.6956521739130435,23,1997,0
danielle steel,Five Days in Paris,1997,101,2.0136986301369864,73,1997,0
danielle steel,The Ghost,1997,102,0,1,1997,0
danielle steel,Malice,1997,103,1.65,60,1997,0
danielle steel,The Ghost,1997,104,3.25,40,1997,0
danielle steel,Special Delivery,1997,105,2.475,40,1997,0
danielle steel,Encuentro Decisivo,1997,106,5,1,1997,0
danielle steel,Daddy,1997,107,0,3,1997,0
danielle steel,Vidas cruzadas,1997,108,0,1,1997,0
danielle steel,Ghost (limited edition),1997,109,9,1,1997,0
danielle steel,Silent Honor,1997,110,1.673913043478261,46,1997,0
danielle steel,The Ghost,1998,111,2.5375,80,1997,1
danielle steel,Special Delivery: A Novel,1998,112,1.576271186440678,59,1998,0
danielle steel,The Long Road Home,1998,113,0,1,1998,0
danielle steel,Mirror Image,1998,114,2.65625,32,1998,0
danielle steel,The Long Road Home,1998,115,2.5789473684210527,38,1998,0
danielle steel,The Klone and I,1998,116,3,2,1998,0
danielle steel,The Klone and I: A High-Tech Love Story,1998,117,1.3142857142857143,35,1998,0
danielle steel,The Klone and I: A High-Tech Love Story (Bantam/Doubleday/Delacorte Press Large Print Collection),1998,118,1,1,1998,0
danielle steel,The Ranch,1998,119,2.3684210526315788,76,1998,0
danielle steel,Ein zufÃ?Â¤lliges Ereignis.,1998,120,0,1,1998,0
danielle steel,His Bright Light: The Story of Nick Traina,1998,121,4.2631578947368425,19,1998,0
danielle steel,Mirror Image,1998,122,0,1,1998,0
danielle steel,The Long Road Home (Large Print Edition),1998,123,0,1,1998,0
danielle steel,Una perfecta desconocida,1998,124,6,1,1998,0
danielle steel,The Long Road Home,1998,125,0,1,1998,0
danielle steel,Granny Dan,1999,126,3.026315789473684,38,1998,1
danielle steel,The Long Road Home,1999,127,2.3461538461538463,78,1999,0
danielle steel,Su Luz Interior - Historia de Su Hijo 245,1999,128,0,1,1999,0
danielle steel,The Klone and I: A High-Tech Love Story,1999,129,2.142857142857143,42,1999,0
danielle steel,Irresistible Forces,1999,130,1,11,1999,0
danielle steel,Granny Dan,1999,131,0,1,1999,0
danielle steel,Gesegnete UmstÃ?Â¤nde.,1999,132,0,1,1999,0
danielle steel,Un monde de rÃ?Âªve,1999,133,0,2,1999,0
danielle steel,Mirror Image,1999,134,1.84375,64,1999,0
danielle steel,Un si long chemin,1999,135,5,1,1999,0
danielle steel,Granny Dan (Bantam/Doubleday/Delacorte Press Large Print),1999,136,5,2,1999,0
danielle steel,Bittersweet (Bantam/Doubleday/Delacorte Press Large Print Collection),1999,137,0,1,1999,0
danielle steel,Malveillance,1999,138,0,1,1999,0
danielle steel,El Largo Camino A Casa,1999,139,4.2,5,1999,0
danielle steel,El anillo,1999,140,7,1,1999,0
danielle steel,El Fantasma (SPANISH),1999,141,8,1,1999,0
danielle steel,Bittersweet,1999,142,2.5384615384615383,13,1999,0
danielle steel,Irresistible Forces,1999,143,0,2,1999,0
danielle steel,His Bright Light: The Story of Nick Traina,1999,144,8,1,1999,0
danielle steel,Changes,1999,145,7,1,1999,0
danielle steel,Bittersweet,2000,146,1.8243243243243243,74,1999,1
danielle steel,Journey,2000,147,2,24,2000,0
danielle steel,Le klone et moi,2000,148,0,1,2000,0
danielle steel,The Wedding,2000,149,0,2,2000,0
danielle steel,The Wedding,2000,150,5.333333333333333,3,2000,0
danielle steel,Irresistible Forces,2000,151,1.3793103448275863,58,2000,0
danielle steel,RelÃ¡mpago,2000,152,6,1,2000,0
danielle steel,His Bright Light : The Story of Nick Traina,2000,153,3.642857142857143,14,2000,0
danielle steel,The Wedding,2000,154,1.2941176470588236,17,2000,0
danielle steel,La bailarina/el clon,2000,155,2,1,2000,0
danielle steel,The Wedding (Limited Edition),2000,156,10,1,2000,0
danielle steel,Granny Dan,2000,157,1.4556962025316456,79,2000,0
danielle steel,The House on Hope Street,2000,158,3.1666666666666665,36,2000,0
danielle steel,Journey,2000,159,5,1,2000,0
danielle steel,The Wedding,2000,160,8,1,2000,0
danielle steel,The House on Hope Street,2000,161,3.5,2,2000,0
danielle steel,The House on Hope Street,2001,162,1.8043478260869565,46,2000,1
danielle steel,Leap of Faith,2001,163,4.666666666666667,27,2001,0
danielle steel,Journey,2001,164,1.6557377049180328,61,2001,0
danielle steel,Lone Eagle,2001,165,2.05,20,2001,0
danielle steel,Lone Eagle,2001,166,0,1,2001,0
danielle steel,Leap of Faith,2001,167,3.5,2,2001,0
danielle steel,The Wedding,2001,168,1.5616438356164384,73,2001,0
danielle steel,Verlorene Spuren.,2001,169,0,1,2001,0
danielle steel,Lone Eagle (Random House Large Print),2001,170,0,1,2001,0
danielle steel,The House on Hope Street,2001,171,0,2,2001,0
danielle steel,Accident,2001,172,7,1,2001,0
danielle steel,The Kiss,2001,173,2.966666666666667,30,2001,0
danielle steel,El Precio del Amor,2001,174,2,2,2001,0
danielle steel,Malicia,2001,175,6,1,2001,0
danielle steel,Unverhofftes GlÃ?Â¼ck.,2002,176,0,2,2001,1
danielle steel,Jewels,2002,177,8,1,2002,0
danielle steel,Answered Prayers,2002,178,3.2222222222222223,36,2002,0
danielle steel,Silenzo E Onore,2002,179,0,1,2002,0
danielle steel,Answered Prayers (Random House Large Print),2002,180,5,1,2002,0
danielle steel,Leap of Faith,2002,181,2.847457627118644,59,2002,0
danielle steel,Sunset in St. Tropez,2002,182,3.1538461538461537,39,2002,0
danielle steel,Encuentro decisivo (Jet de Plaza &amp; Janes),2002,183,3.5,2,2002,0
danielle steel,The Kiss,2002,184,1.9863013698630136,73,2002,0
danielle steel,Answered Prayers (Limited Edition),2002,185,5,1,2002,0
danielle steel,The Cottage,2002,186,3.129032258064516,31,2002,0
danielle steel,The Cottage,2002,187,0,1,2002,0
danielle steel,Lone Eagle,2002,188,1.6981132075471699,53,2002,0
danielle steel,The Cottage: A Novel,2002,189,5,1,2002,0
danielle steel,El Viaje,2002,190,0,1,2002,0
danielle steel,Die Traumhochzeit.,2002,191,0,1,2002,0
danielle steel,Johnny Angel,2003,192,2.8085106382978724,47,2002,1
danielle steel,Answered Prayers,2003,193,2.088888888888889,45,2003,0
danielle steel,Sunset in St. Tropez,2003,194,2.13953488372093,43,2003,0
danielle steel,Safe Harbour,2003,195,3.3333333333333335,3,2003,0
danielle steel,Answered Prayers,2003,196,0,1,2003,0
danielle steel,Kaleidoscope,2003,197,9,1,2003,0
danielle steel,Safe Harbour,2003,198,3.375,24,2003,0
danielle steel,Die Erscheinung.,2003,199,0,3,2003,0
danielle steel,The Cottage,2003,200,2.4393939393939394,66,2003,0
danielle steel,Dating Game,2003,201,3.189189189189189,37,2003,0
danielle steel,Dating Game (Limited Edition),2003,202,6,1,2003,0
danielle steel,Second Chance,2004,203,6.666666666666667,6,2003,1
danielle steel,Johnny Angel,2004,204,1.9230769230769231,13,2004,0
danielle steel,Dating Game,2004,205,1.5365853658536586,41,2004,0
danielle steel,Ransom,2004,206,0,2,2004,0
danielle steel,"Ransom (Steel, Danielle)",2004,207,3.1666666666666665,18,2004,0
danielle steel,Ransom (Limited Edition),2004,208,0,1,2004,0
danny abelson,The Muppets Take Manhattan: The Storybook Based on the Movie,1984,2,0,1,1984,0
danny bonaduce,Random Acts of Badness,2002,2,5,2,2001,1
danuta reah,Night angels,2001,2,0,1,2000,1
danuta reah,Listen to the Shadows: A Novel,2001,3,10,1,2001,0
danuta reah,Letzter Halt.,2002,4,3.5,2,2001,1
danzy senna,Caucasia,1999,2,3.4444444444444446,18,1998,1
daphne gottlieb,Final Girl,2003,2,8,1,2001,2
daphne scholinski,The Last Time I Wore a Dress,1998,2,2.6666666666666665,6,1997,1
darin strauss,Chang und Eng. Die siamesischen Zwillinge.,2000,2,7,1,2000,0
darin strauss,Chang and Eng: A Novel,2001,3,2.7857142857142856,28,2000,1
darlene zschech,The Kiss of Heaven: God's Favor to Empower Your Life Dream,2003,2,6,1,2001,2
darnella ford,Crave,2004,2,10,1,2002,2
dashiell hammett,El halcÃ³n maltÃ©s,1969,2,0,1,1968,1
dashiell hammett,The Dain curse,1972,3,0,2,1969,3
dashiell hammett,Thin Man,1972,4,2.2142857142857144,14,1972,0
dashiell hammett,Glass Key,1972,5,5.666666666666667,3,1972,0
dashiell hammett,The big knockover;: Selected stories and short novels,1972,6,4,2,1972,0
dashiell hammett,Maltese Falcon,1972,7,1.6,15,1972,0
dashiell hammett,Red harvest,1972,8,2.6666666666666665,3,1972,0
dashiell hammett,The Continental Op,1974,9,5,1,1972,2
dashiell hammett,Dain Curse,1978,10,6.5,2,1974,4
dashiell hammett,Dashiell Hammett: Five Complete Novels,1987,11,0,1,1978,9
dashiell hammett,The Maltese Falcon,1987,12,0,1,1987,0
dashiell hammett,Woman in the Dark,1988,13,8,1,1987,1
dashiell hammett,The Continental Op (Vintage Crime),1989,14,6,4,1988,1
dashiell hammett,Woman in the Dark: A Novel of Dangerous Romance (Vintage Crime),1989,15,0,2,1989,0
dashiell hammett,The Maltese Falcon (Vintage Crime/Black Lizard),1989,16,2.6904761904761907,42,1989,0
dashiell hammett,The Dain Curse (Vintage Crime),1989,17,2.8,5,1989,0
dashiell hammett,The Glass Key (Vintage Crime),1989,18,3,5,1989,0
dashiell hammett,Dashiell Hammett: 5 Complete Novels,1991,19,2.5,4,1989,2
dashiell hammett,Red Harvest (Vintage Crime/Black Lizard),1992,20,2.857142857142857,7,1991,1
dashiell hammett,The Thin Man (Vintage Crime/Black Lizard),1992,21,4.5625,16,1992,0
dashiell hammett,"Llave de Cristal, La",1993,22,3.5,2,1992,1
dashiell hammett,The Big Knockover: Selected Stories and Short Novels (Vintage Crime),1994,23,2.5,2,1993,1
dashiell hammett,Red Harvest (Isis Series),1996,24,0,1,1994,2
dashiell hammett,Una Mujer En LA Oscuridad,1996,25,0,2,1996,0
dashiell hammett,Cosecha Roja,1998,26,10,1,1996,2
dashiell hammett,Rote Ernte.,1999,27,0,1,1998,1
dashiell hammett,Cuando Uno Esta de Suerte,1999,28,1,1,1999,0
dashiell hammett,Der Malteser Falke.,1999,29,8,1,1999,0
dashiell hammett,The Maltese Falcon (Vintage Crime),1999,30,7,1,1999,0
dashiell hammett,Dashiell Hammett : Complete Novels : Red Harvest / The Dain Curse / The Maltese Falcon / The Glass Key / The Thin Man (Library of America),1999,31,0,1,1999,0
dashiell hammett,"The Maltese Falcon, the Thin Man, Red Harvest: The Thin Man ; Red Harvest (Everyman's Library (Cloth))",2000,32,9,1,1999,1
dashiell hammett,Nightmare Town: Stories,2000,33,0,1,2000,0
dashiell hammett,Selected Letters of Dashiell Hammett,2001,34,0,1,2000,1
dashiell hammett,The Dain Curse (Crime Masterworks S.),2002,35,0,1,2001,1
dashiell hammett,The Maltese Falcon (Crime Masterworks S.),2002,36,2.6666666666666665,3,2002,0
dav pilkey,Kat Kong,1993,2,5,2,1992,1
dav pilkey,Dogzilla,1993,3,5,2,1993,0
dav pilkey,A Friend for Dragon: Dragon's First Tale (The Dragon Tales),1994,4,5,2,1993,1
dav pilkey,Dog Breath: The Horrible Trouble with Hally Tosis,1994,5,0,1,1994,0
dav pilkey,The Hallo-wiener,1995,6,0,1,1994,1
dav pilkey,Dragon's Fat Cat (Dragon Tales),1995,7,0,1,1995,0
dav pilkey,When Cats Dream (Orchard Paperbacks),1996,8,0,2,1995,1
dav pilkey,god bless the gargoyles,1996,9,0,1,1996,0
dav pilkey,The Paperboy (Caldecott Honor Book),1996,10,0,1,1996,0
dav pilkey,The Adventures of Captain Underpants: An Epic Novel (Captain Underpants),1997,11,2.225,40,1996,1
dav pilkey,Captain Underpants and the Attack of the Talking Toilets: Another Epic Novel (Captain Underpants (Paper)),1999,12,3.5348837209302326,43,1997,2
dav pilkey,Captain Underpants and the Invasion of the Incredibly Naughty Cafeteria Ladies from Outer Space,1999,13,2.5217391304347827,46,1999,0
dav pilkey,Captain Underpants and the Invasion of the Incredibly Naughty Cafeteria Ladies from Outer Space,1999,14,0,1,1999,0
dav pilkey,The Hallo-Wiener,1999,15,10,1,1999,0
dav pilkey,Captain Underpants and the Perilous Plot of Professor Poopypants: The Fourth Epic Novel (Captain Underpants (Paperback)),2000,16,2.5681818181818183,44,1999,1
dav pilkey,Ricky Ricotta's Mighty Robot Vs. the Mutant Mosquitoes from Mercury: The Second Robot Adventure Noel (Ricky Ricotta),2000,17,1.25,8,2000,0
dav pilkey,Ricky Ricotta's Mighty Robot,2000,18,3,5,2000,0
dav pilkey,Ricky Ricotta's Giant Robot: An Adventure Novel (Ricky Ricotta),2000,19,8,1,2000,0
dav pilkey,The Silly Gooses,2000,20,0,1,2000,0
dav pilkey,Captain Underpants and the Perilous Plot of Professor Poopypants: The Fourth Epic Novel (Captain Underpants),2000,21,9,1,2000,0
dav pilkey,Captain Underpants and the Wrath of the Wicked Wedgie Woman,2001,22,2.4838709677419355,31,2000,1
dav pilkey,The Captain Underpants Extra-Crunchy Book O' Fun,2001,23,0,6,2001,0
dav pilkey,Captain Underpants and the Wrath of the Wicked Wedgie Woman (Captain Underpants Book 5),2001,24,5,1,2001,0
dav pilkey,Ricky Ricotta's Giant Robot Vs. the Voodoo Vultures from Venus (The Third Robot Adventure Novel),2001,25,0,4,2001,0
dav pilkey,Ricky Ricotta's Mighty Robot Vs. the Mecha-Monkeys from Mars: The Fourth Robot Adventure Novel (Ricky Ricotta),2002,26,2.5,2,2001,1
dav pilkey,Las Aventuras Del Capitan Calzoncillos (Captain Underpants (Spanish)),2002,27,1.6666666666666667,6,2002,0
dav pilkey,Captain Underpants And The Perilous Plot Of Professor Poopypants: El Capitan Calzoncillos Y El Perverso Plan Del Profesor Pipcac,2002,28,0,2,2002,0
dav pilkey,The All New Captain Underpants Extra Crunchy Book of Fun (Captain Underpants),2002,29,0,1,2002,0
dav pilkey,The New Captain Underpants Collection:  Box Set (Books 1-5),2002,30,10,1,2002,0
dav pilkey,The Adventures of Super Diaper Baby: The First Graphic Novel,2002,31,2.066666666666667,15,2002,0
dav pilkey,El Capitan Calzoncillos Y El Ataque De Los Inodoros Parlantes: Otra Novela Epica (Captain Underpants (Spanish)),2002,32,5,2,2002,0
dav pilkey,"Captain Underpants and the Big, Bad Battle of the Bionic Booger Boy, Part 1: The Night of the Nasty Nostril Nuggets",2003,33,2.6666666666666665,6,2002,1
dav pilkey,Ricky Ricotta's Mighty Robot Vs. Stupid Stinkbugs from Saturn: The Sixth Robot Adventure Novel (Ricky Ricotta),2003,34,9,1,2003,0
dav pilkey,"Captain Underpants and the Big, Bad Battle of the Bionic Booger Boy, Part 2 : Revenge of the Ridiculous Robo-boogers (Captain Underpants)",2003,35,3.6666666666666665,12,2003,0
dav pilkey,El Capitan Calzoncillos Y LA Furia De LA Supermujer Macroelastica (Captain Underpants (Spanish)),2003,36,2.5,2,2003,0
dave hunt,Beyond Seduction: A Return to Biblical Christianity,1986,2,0,1,1985,1
dave hunt,The Archon Conspiracy,1989,3,1.125,8,1986,3
dave hunt,A Woman Rides the Beast,1994,4,7,1,1989,5
dave hunt,An Urgent Call to a Serious Faith,2000,5,10,1,1994,6
dave olsen,Starbucks Passion for Coffee,1994,2,2.6666666666666665,9,1994,0
dave pelzer,"""A Child Called \It"""": One Child's Courage to Survive""""""",1995,2,4.091603053435114,262,1995,0
dave pelzer,The Lost Boy: A Foster Child's Search for the Love of a Family,1997,3,3.8523489932885906,149,1995,2
dave pelzer,The Lost Boy: A Foster Child's Search for the Love of a Family,1999,4,10,1,1997,2
dave pelzer,"""A Child Called \It"""": One Child's Courage to Survive""""""",2001,5,3.6666666666666665,3,1999,2
dave pelzer,A Man Named Dave (Wheeler Large Print Press (large print paper)),2001,6,10,1,2001,0
dave pelzer,The Lost Boy,2001,7,4.043478260869565,23,2001,0
dave pelzer,Lost Boy,2001,8,4,4,2001,0
dave pelzer,Sie Nannten Mich Es,2002,9,4,1,2001,1
dave pelzer,The Privilege of Youth: A Teenager's Story of Longing for Acceptance and Friendship,2004,10,5.5,8,2002,2
david a adler,The fourth floor twins and the silver ghost express (The fourth floor twins),1986,2,0,1,1985,1
david a. vise,"The Bureau and the Mole: The Unmasking of Robert Philip Hanssen, the Most Dangerous Double Agent in FBI History",2001,2,0.5,4,1991,10
david a. whetten,Developing Management Skills (4th Edition),1998,2,0,2,1991,7
david a. yallop,In Gods Name,1985,2,4.5,2,1984,1
david a. yallop,In God's Name: An Investigation into the Murder of Pope John Paul I,1997,3,1.75,4,1985,12
david a. yallop,Unheilige Allianz.,2000,4,0,1,1997,3
david aaron,STATE SCARLET,1988,2,0,5,1987,1
david aaron,Agent of Influence,1990,3,3,2,1988,2
david aaron,ENDLESS LIGHT,1997,4,0,2,1990,7
david aaron,"Endless Light: The Ancient Path of the Kabbalah to Love, Spiritual Growth, and Personal Power",1998,5,8,1,1997,1
david aaron,Seeing God: Ten Life-Changing Lessons of the Kabbalah,2002,6,0,1,1998,4
david adams leeming,A Dictionary of Creation Myths (Oxford Paperback Reference S.),1995,2,0,1,1992,3
david adams leeming,Myth: A Biography of Belief,2001,3,6,1,1995,6
david allen sibley,The Sibley Guide to Bird Life &amp; Behavior,2001,2,5,2,2000,1
david anthony durham,Gabriel's Story,2002,2,0,3,2001,1
david anthony durham,Walk Through Darkness,2002,3,9,1,2002,0
david arora,"All That the Rain Promises, and More ...: A Hip Pocket Guide to Western Mushrooms",1991,2,9.666666666666666,3,1986,5
david b. ellis,Becoming a Master Student,1991,2,0,1,1986,5
david baddiel,Time for Bed,1997,2,2.769230769230769,13,1996,1
david baddiel,Ab ins Bett.,1999,3,0,2,1997,2
david baddiel,Whatever Love Means,2000,4,0,3,1999,1
david baddiel,Whatever Love Means,2000,5,4.461538461538462,13,2000,0
david baddiel,Whatever Love Means,2000,6,7,1,2000,0
david baddiel,"L'Amour, si Ã?Â§a veut dire quelque choseÃ?Â?",2002,7,0,2,2000,2
david barrett,Runes (Predictions Library),1995,2,0,1,1995,0
david bell,The Cybercultures Reader,2000,2,8,1,1995,5
david bishop,"Princess And The Pauper (Special Edition, No 545)",1989,2,0,1,1984,5
david bishop,"Dear Diary (Silhouette Special Edition, No 596)",1990,3,0,2,1989,1
david bishop,Going For It (Harlequin Temptation No 376),1991,4,1.1666666666666667,6,1990,1
david bishop,"Romancing Rachel (Silhouette Special Edition, No 700)",1991,5,0,2,1991,0
david bishop,"Downright Dangerous (Silhouette Special Edition, No. 651)",1991,6,1.4,5,1991,0
david bishop,"Falling Stars (Harlequin Intrigue, No 232)",1993,7,0,1,1991,2
david bishop,Cursed Earth Asylum (Judge Dredd),1995,8,0,1,1993,2
david bishop,"Hot Blooded (Harlequin Intrigue, No 22314)",1995,9,0,2,1995,0
david bishop,"Heart Throb (Pulse) (Harlequin Intrigue, No 323)",1995,10,0,1,1995,0
david bishop,"Breathless (Pulse) (Harlequin Intrigue, No 319)",1995,11,0,1,1995,0
david bishop,"Reckless Lover (Dangerous Men) (Harlequin Intrigue, No 357)",1996,12,0,3,1995,1
david bishop,Soulmate (Avenging Angels) (Harlequin Intrigue),1996,13,0,3,1996,0
david bishop,"Shadow Lover  (My Bodyguard) (Harlequin Intrigue, No 394)",1996,14,2.3333333333333335,3,1996,0
david bishop,"Valentine'S Child (Silhouette Special Edition, No 1086)",1997,15,0,1,1996,1
david bishop,Angel With An Attitude  (Avenging Angels) (Harlequin Intrigue),1997,16,0,6,1997,0
david bishop,"Mcquaid'S Justice  (The Cowboy Code) (Harlequin Intrigue, 497)",1998,17,2,5,1997,1
david bishop,"Watch Over Me  (Rocky Mountain Rescue) (Harlequin Intrigue, No 454)",1998,18,1.6666666666666667,6,1998,0
david bishop,"No Baby But Mine (Lovers Under Cover) (Harlequin Intrigue, No. 538)",1999,19,0,2,1998,1
david bishop,No Bride But His (Lovers Under Cover) (Harlequin Intrigue),2000,20,2.75,4,1999,1
david bishop,"Bright Lights, Baked Ziti: The Unofficial, Unauthorised Guide to the Sopranos",2001,21,2.6666666666666665,3,2000,1
david brinkley,Washington Goes to War,1989,2,2,4,1988,1
david brinkley,"David Brinkley: 11 Presidents, 4 Wars, 22 Political Conventions, 1 Moon Landing, 3 Assassinations, 2,000 Weeks of News and Other Stuff on Television",1995,3,3.5,2,1989,6
david brinkley,Everyone Is Entitled to My Opinion,1996,4,1.6153846153846154,13,1995,1
david brinkley,Everyone Is Entitled to My Opinion,1996,5,8,1,1996,0
david brinkley,David Brinkley: A Memoir,1996,6,1.5,6,1996,0
david brinkley,Everyone Is Entitled to My Opinion,1997,7,2.3333333333333335,3,1996,1
david brinkley,"Brinkley's Beat : People, Places, and Events That Shaped My Time (Random House Large Print)",2003,8,0,2,1997,6
david brooks,Die Bobos. Der Lebensstil der neuen Elite.,2001,2,0,1,2000,1
david brooks,Bobos In Paradise: The New Upper Class and How They Got There,2001,3,1.894736842105263,19,2001,0
david burn,Instant Guide to Horses (Instant Guide.),2000,2,8.5,2,2000,0
david c. smith,"When Hell Laughs (Red Sonja, #3)",1982,2,0,1,1981,1
david c. smith,"The Ring of Ikribu (Red Sonja, Book 1)",1983,3,8,1,1982,1
david c. smith,"Star of Doom (Red Sonja, Book 6)",1983,4,0,1,1983,0
david c. smith,Master of Evil,1983,5,2,6,1983,0
david c. smith,H.G. Wells: Desperately Mortal : A Biography,1986,6,3.5,2,1983,3
david champion,Nobody Roots for Goliath: A Bomber Hanson Mystery,1996,2,0,1,1995,1
david cian,The Transformers : Book 3: Fusion (Transformers (Ibooks)),2004,2,0,1,2003,1
david colbert,Eyewitness to the American West: 500 Years of Firsthand History,1999,2,0,1,1997,2
david colbert,"The Magical Worlds of Harry Potter: A Treasury of Myths, Legends, and Fascinating Facts",2001,3,0,2,1999,2
david colbert,The Magical Worlds of Harry Potter,2001,4,2,5,2001,0
david colbert,"The Magical Worlds of the \Lord of the Rings""""""""",2002,5,6,2,2001,1
david colbert,"The Magical Worlds of the Lord of the Rings: The Amazing Myths, Legends, and Facts Behind the Masterpiece",2002,6,4,2,2002,0
david colbert,"The Magical Worlds of Harry Potter: A Treasury of Myths, Legends, and Fascinating Facts",2002,7,3.2,10,2002,0
david crow,In Search of the Medicine Buddha: A Himalayan Journey,2001,2,0,2,2000,1
david crystal,Rediscover Grammar,1990,2,0,1,1986,4
david crystal,The Cambridge Encyclopedia of Language,1991,3,0,2,1990,1
david crystal,The Cambridge Biographical Encyclopedia,1994,4,10,1,1991,3
david crystal,The Cambridge Encyclopedia,1994,5,0,1,1994,0
david crystal,The Cambridge Factfinder,1995,6,7,1,1994,1
david crystal,A Dictionary of Linguistics and Phonetics (Language Library),1997,7,0,1,1995,2
david crystal,The Cambridge Encyclopedia of the English Language,1997,8,7,2,1997,0
david crystal,The Cambridge Encyclopedia of Language,1997,9,0,1,1997,0
david crystal,The Cambridge Factfinder,2000,10,10,1,1997,3
david crystal,Shakespeare's Words: A Glossary and Language Companion,2002,11,9,1,2000,2
david crystal,Language Death,2002,12,0,1,2002,0
david d. burns,Feeling Good: The New Mood Therapy,1981,2,6,3,1980,1
david d. burns,Feeling Good: The New Mood Therapy,1981,3,3.2857142857142856,7,1981,0
david d. burns,Feeling Good: The New Mood Therapy,1981,4,0,1,1981,0
david d. burns,The Feeling Good Handbook (Plume),1990,5,1.75,4,1981,9
david d. burns,Feeling Good : The New Mood Therapy,1999,6,1.25,4,1990,9
david d. burns,The Feeling Good Handbook,1999,7,2.4444444444444446,9,1999,0
david d. burns,Ten Days to Self-Esteem,1999,8,2.6666666666666665,3,1999,0
david d. burns,Feeling Good : The New Mood Therapy,1999,9,2.8461538461538463,13,1999,0
david damrosch,"The Longman Anthology of British Literature, Volume 2B: The Victorian Age (2nd Edition)",2002,2,0,1,1998,4
david damrosch,"The Longman Anthology of British Literature, Volume 2A: The Romantics and Their Contemporaries (2nd Edition)",2002,3,0,1,2002,0
david edmonds,Wittgenstein's Poker: The Story of a Ten-Minute Argument Between Two Great Philosophers,2001,2,5,3,2000,1
david edmonds,Wittgenstein's Poker: The Story of a Ten-Minute Argument Between Two Great Philosophers,2001,3,6,3,2001,0
david edmonds,Wittgenstein's Poker : The Story of a Ten-Minute Argument Between Two Great Philosophers,2002,4,1.1666666666666667,6,2001,1
david edmonds,Wittgenstein's Poker: The Story of a Ten Minute Argument Between Two Great Philosophers,2002,5,0,1,2002,0
david edmonds,Bobby Fischer Goes to War : How the Soviets Lost the Most Extraordinary Chess Match of All Time,2004,6,2.6666666666666665,3,2002,2
david eldridge,Sea Monsters: Ancient Reptiles That Ruled the Sea,1987,2,0,1,1979,8
david fraser,DRAGONS TEETH,1988,2,0,1,1979,9
david fraser,The Seizure,1989,3,0,1,1988,1
david fraser,Knight's Cross: A Life of Field Marshal Erwin Rommel,1994,4,0,2,1989,5
david fraser,Knight's Cross : A Life of Field Marshal Erwin Rommel,1995,5,4.5,2,1994,1
david fraser,Frederick the Great: King of Prussia,2001,6,9,1,1995,6
david freemantle,"140 neue Tipps fÃ?Â¼r tolle Chefs... ...und solche, die es werden wollen.",2002,2,7,1,2000,2
david g. miller,Brewing the World's Great Beers: A Step-By-Step Guide,1992,2,7,1,1988,4
david g. miller,Brewing the World's Great Beers: A Step-By-Step Guide,1992,3,0,2,1992,0
david gibbon,Kittens : Color Nature Library (Color Nature Library),1988,2,0,1,1988,0
david goodis,Shoot the Piano Player (Vintage Crime/Black Lizard),1990,2,3.5,2,1987,3
david goodis,Nightfall (Vintage Crime/Black Lizard),1991,3,0,1,1990,1
david goodis,Night Squad (Vintage Crime/Black Lizard),1992,4,0,1,1991,1
david graham,Wacky Riddles and Rhymes,1992,2,0,2,1982,10
david h. maister,True Professionalism,1997,2,5,1,1993,4
david h. maister,Managing The Professional Service Firm,1997,3,0,1,1997,0
david h. maister,The Trusted Advisor,2000,4,0,1,1997,3
david h. maister,Practice What You Preach : What Managers Must Do to Create a High Achievement Culture,2001,5,0,1,2000,1
david halberstam,The Breaks of the Game,1981,2,0,1,1973,8
david halberstam,The Powers That Be,1983,3,0,2,1981,2
david halberstam,The Breaks of the Game,1983,4,0,1,1983,0
david halberstam,One Very Hot Day,1984,5,0,1,1983,1
david halberstam,The Reckoning,1986,6,2.6666666666666665,3,1984,2
david halberstam,The Reckoning,1988,7,2.3333333333333335,3,1986,2
david halberstam,Summer of '49,1990,8,2.1818181818181817,11,1988,2
david halberstam,"Best American Sports Writing, 1991",1991,9,0,1,1990,1
david halberstam,The Next Century,1991,10,0,2,1991,0
david halberstam,The Fifties,1993,11,3,7,1991,2
david halberstam,The Best and the Brightest,1993,12,0,1,1993,0
david halberstam,The Fifties,1994,13,9.5,2,1993,1
david halberstam,October 1964,1994,14,3,8,1994,0
david halberstam,October 1964,1995,15,4,2,1994,1
david halberstam,The Amateurs,1996,16,0,1,1995,1
david halberstam,The Children,1998,17,3,6,1996,2
david halberstam,The Children,1999,18,7,1,1998,1
david halberstam,Playing for Keeps: Michael Jordan and the World That He Made,1999,19,5,3,1999,0
david halberstam,Playing for Keeps: Michael Jordan and the World He Made,1999,20,3.5,2,1999,0
david halberstam,Playing for Keeps : Michael Jordan and the World He Made,2000,21,0,1,1999,1
david halberstam,"War in a Time of Peace: Bush, Clinton, and the Generals",2001,22,3.5,4,2000,1
david halberstam,The Best and the Brightest,2001,23,2.5,2,2001,0
david halberstam,"War in a Time of Peace: Bush, Clinton, and the Generals",2002,24,4,2,2001,1
david halberstam,Firehouse,2002,25,5.1,10,2002,0
david halberstam,The Teammates,2003,26,4.333333333333333,6,2002,1
david halberstam,Firehouse,2003,27,4.8,5,2003,0
david halberstam,The Teammates: A Portrait of a Friendship,2004,28,7,1,2003,1
david herter,Evening's Empire,2003,2,9,1,2001,2
david hewson,Solstice,1999,2,0,3,1999,0
david hewson,Solstice,2001,3,0,1,1999,2
david hewson,Sonnenwende.,2002,4,0,1,2001,1
david hewson,Lucifer's Shadow,2004,5,4.5,2,2002,2
david hewson,A Season for the Dead,2004,6,6,3,2004,0
david horowitz,RADICAL SON: A GENERATIONAL ODYSSEY,1998,2,0,1,1997,1
david horowitz,Hating Whitey: And Other Progressive Causes,1999,3,0,2,1998,1
david icke,The Biggest Secret: The Book That Will Change the World,1999,2,0,1,1997,2
david icke,Alice in Wonderland and the World Trade Center Disaster,2002,3,4.5,2,1999,3
david icke,Tales from the Time Loop: The Most Comprehensive Expos of the Global Conspiracy Ever Written and All You Need to Know to Be Truly Free,2003,4,0,1,2002,1
david james duncan,River Why,1984,2,5,2,1984,0
david james duncan,The River Why,1988,3,4.8125,16,1984,4
david james duncan,Brothers K,1992,4,4,2,1988,4
david james duncan,The Brothers K,1992,5,9,1,1992,0
david james duncan,The Brothers K,1993,6,3.9285714285714284,14,1992,1
david james duncan,River Teeth,1996,7,3.4,5,1993,3
david james duncan,The Brothers K,1996,8,5.75,8,1996,0
david james duncan,The Brothers K,1996,9,10,1,1996,0
david james duncan,La Vie selon Gus Orviston,1999,10,8,1,1996,3
david james duncan,"My Story as Told by Water: Confessions, Druidic Rants, Reflections, Bird-Watchings, Fish-Stalkings, Visions, Songs and Prayers Refracting Light, from Living Rivers, in the Age of the Industrial Dark",2001,11,0,2,1999,2
david james duncan,"The River Why, Twentieth-Anniversary Edition",2002,12,0,2,2001,1
david joachim,"A Man, a Can, a Plan: 50 Great Guy Meals Even You Can Make",2002,2,2,5,2001,1
david katz,LAST DANCE IN REDONDO BEACH,1990,2,0,1,1988,2
david katz,The Osbournes,2002,3,0,1,1990,12
david klass,"Samurai, Inc.",1992,2,3,2,1990,2
david klass,California Blue,1996,3,0,3,1992,4
david klass,Danger Zone (Point Signature),1998,4,0,3,1996,2
david klass,You Don't Know Me,2001,5,9,1,1998,3
david klass,You Don't Know Me,2002,6,4.5,4,2001,1
david l. pulver,Gurps Vehicles: From Chariots to Cybertanks...and Beyond! (GURPS: Generic Universal Role Playing System),1998,2,0,1,1996,2
david lambkin,Das dunkle Land.,2001,2,4,2,1996,5
david larkin,Faeries,1995,2,10,2,1979,16
david lavender,The Southwest,1984,2,5.333333333333333,3,1972,12
david lavender,The Way to the Western Sea: Lewis and Clark Across the Continent,2001,3,0,1,1984,17
david lee roth,Crazy from the Heat,1998,2,0,1,1997,1
david lipsky,Absolutely American: Four Years at West Point,2003,2,6.166666666666667,6,1996,7
david lipsky,Absolutely American : Four Years at West Point (Vintage),2004,3,4,2,2003,1
david lubar,"The Vanishing Vampire (The Accidental Monsters , No 1)",1997,2,1.5,4,1995,2
david lubar,Monster Road,1999,3,4.25,4,1997,2
david lubar,Hidden Talents,2000,4,2,2,1999,1
david lubar,Hidden Talents (Starscape),2003,5,0.7142857142857143,7,2000,3
david lubar,In the Land of the Lawn Weenies and Other Misadventures (Starscape),2003,6,3,3,2003,0
david m. buss,The Evolution of Desire: Strategies of Human Mating,1995,2,8.5,2,1994,1
david m. buss,The Dangerous Passion: Why Jealousy Is As Necessary As Love and Sex,2000,3,0,1,1995,5
david macaulay,Pyramid,1975,2,10,1,1974,1
david macaulay,Castle,1977,3,0,3,1975,2
david macaulay,Great Moments in Architecture,1978,4,10,1,1977,1
david macaulay,Motel of the Mysteries,1979,5,1.2,5,1978,1
david macaulay,Cathedral : The Story of Its Construction,1981,6,2,4,1979,2
david macaulay,Pyramid,1982,7,0,1,1981,1
david macaulay,Castle,1982,8,4.5,4,1982,0
david macaulay,Underground,1983,9,0,2,1982,1
david macaulay,City : A Story of Roman Planning and Construction,1983,10,3.3333333333333335,3,1983,0
david macaulay,Baaa,1985,11,10,1,1983,2
david macaulay,Unbuilding,1987,12,10,1,1985,2
david macaulay,Way Things Work,1988,13,9,2,1987,1
david macaulay,Way Things Work,1988,14,3.3333333333333335,3,1988,0
david macaulay,Mill,1989,15,10,1,1988,1
david macaulay,Black and White (Caldecott Medal Book),1990,16,9,1,1989,1
david macaulay,Shortcut,1999,17,8,1,1990,9
david macaulay,Building Big,2000,18,10,1,1999,1
david macaulay,The Way Things Work Kit,2000,19,8,1,2000,0
david macaulay,Angelo,2002,20,0,1,2000,2
david macaulay,Mosque,2003,21,10,1,2002,1
david maraniss,First In His Class : A Biography Of Bill Clinton,1996,2,0,1,1995,1
david maraniss,Tell Newt to Shut Up : Prize-Winning Washington Post Journalists Reveal How Reality Gagged the Gingrich Revolution,1996,3,0,2,1996,0
david maraniss,When Pride Still Mattered : A Life of Vince Lombardi,1999,4,0,1,1996,3
david maraniss,WHEN PRIDE STILL MATTERED : A Life of Vince Lombardi,1999,5,0,2,1999,0
david maraniss,When Pride Still Mattered : A Life Of Vince Lombardi,2000,6,0,2,1999,1
david maraniss,The Prince of Tennessee : Al Gore Meets His Fate,2000,7,2,2,2000,0
david maraniss,They Marched Into Sunlight: War and Peace Vietnam and America October 1967,2003,8,2.6666666666666665,3,2000,3
david mckee,Le Nouvel Ami d'Elmer,2002,2,10,1,1989,13
david mcrobbie,See How They Run,1997,2,0,1,1994,3
david mcrobbie,Tyro,1999,3,3,2,1997,2
david niall wilson,"To Sift Through Bitter Ashes (The Grails Covenant , No 1)",1997,2,0,2,1997,0
david niall wilson,"To Speak in Lifeless Tongues (The Grails Covenant , Vol 2)",1998,3,0,2,1997,1
david niall wilson,Deep Blue,2004,4,10,1,1998,6
david owen,South Arm,1995,2,6,1,1992,3
david owen,Hidden Evidence: Forty true crimes and how forensic science helped solve them,2000,3,2.5,6,1995,5
david owen,Hidden Secrets: A Complete History of Espionage and the Technology Used to Support It,2002,4,0,1,2000,2
david peters,"Main Street D.O.A. (Psi Man, No 3)",1991,2,0,1,1990,1
david peters,From the Beginning: The Story of Human Evolution,1991,3,0,1,1991,0
david peters,"The Chaos Kid (Psi-Man, No. 4)",1991,4,0,1,1991,0
david peters,"Stalker (Psi Man, No 5)",1991,5,0,1,1991,0
david peters,"Deathscape (Psi-Man, No 2)",1991,6,0,1,1991,0
david peters,"Haven (Psi-Man, No 6)",1992,7,0,1,1991,1
david plante,The Age of Terror,1999,2,0,2,1984,15
david plante,The Age of Terror,1999,3,0,1,1999,0
david pond,Chakras for Beginners: A Guide to Balancing Your Chakra Energies (For Beginners),1999,2,0,1,1984,15
david protess,A Promise of Justice : The Eighteen-Year Fight to Save Four Innocent Men,1998,2,0,1,1994,4
david quammen,Natural Acts: A Sidelong View of Science and Nature,1985,2,8,3,1984,1
david quammen,Natural Acts: A Sidelong View of Science and Nature,1986,3,8,1,1985,1
david quammen,Flight of the Iguana: A Sidelong View of Science and Nature,1988,4,0,2,1986,2
david quammen,The Flight of the Iguana: A Sidelong View of Science and Nature,1989,5,8,3,1988,1
david quammen,The SONG OF THE DODO: ISLAND BIOGEOGRAPHY IN AN AGE OF EXTINCTIONS,1997,6,2.5,4,1989,8
david quammen,The FLIGHT OF THE IGUANA: A SIDELONG VIEW OF SCIENCE AND NATURE,1998,7,1.125,8,1997,1
david quammen,WILD THOUGHTS FROM WILD PLACES,1998,8,1.8,5,1998,0
david quammen,The Best American Science &amp; Nature Writing 2000,2000,9,7,6,1998,2
david quammen,The Boilerplate Rhino : Nature in the Eye of the Beholder,2000,10,4.5,2,2000,0
david quammen,The Boilerplate Rhino: Nature in the Eye of the Beholder,2001,11,3.375,8,2000,1
david quammen,Monster of God: The Man-Eating Predator in the Jungles of History and the Mind,2003,12,3.5555555555555554,9,2001,2
david r. johnson,Making Minutes Count Even More,1986,2,0,1,1982,4
david r. slavitt,Salazar Blinks (Collier Fiction),1990,2,0,1,1984,6
david r. slavitt,Eclogues and Georgics of Virgil,1990,3,0,1,1990,0
david rains wallace,Untamed Garden and Other Personal Essays,1988,2,4,2,1987,1
david rains wallace,"The Bonehunters' Revenge: Dinosaurs, Greed, and the Greatest Scientific Feud of the Gilded Age",1999,3,3,3,1988,11
david ramus,Thief of Light,1997,2,0,3,1995,2
david ramus,El Ladron De Imagenes,1998,3,0,1,1997,1
david ramus,The Gravity of Shadows : A Novel,1999,4,0,2,1998,1
david ramus,On Ice : A Thriller,2000,5,0,1,1999,1
david ramus,On Ice,2001,6,0,3,2000,1
david rees,Quince,1993,2,8,1,1980,13
david rees,Get Your War On,2002,3,4.923076923076923,13,1993,9
david rees,My New Fighting Technique Is Unstoppable,2003,4,9,1,2002,1
david ryan long,Quinlin's Estate,2002,2,1.75,4,2001,1
david s. neft,The Sports Encyclopedia,1988,2,10,1,1978,10
david s. neft,The Sports Encyclopedia: Baseball (Sports Encyclopedia: Baseball),1996,3,9,1,1988,8
david s. neft,The Sports Encyclopedia: Baseball 2001 (Sports Encyclopedia Baseball),2001,4,9,1,1996,5
david schiller,The Little Zen Companion,1994,2,7.142857142857143,7,1994,0
david schiller,A Little Book of Prayers,1997,3,0,1,1994,3
david sibley,The Sibley Field Guide to Birds of Eastern North America,2003,2,7,1,2002,1
david st clair,Mine to Kill,1987,2,0,1,1979,8
david stout,The Dog Hermit,1993,2,0,1,1988,5
david stout,Night of the Devil: The Untold Story of Thomas Trantino and the Angel Lounge Killings,2003,3,6,1,1993,10
david treuer,Little : A Novel,1996,2,0,1,1995,1
david webster,Summer (Exploring Nature Around the Year),1990,2,0,2,1990,0
david wheeler,The Penguin Book of Garden Writing,1999,2,0,1,1991,8
david wind,The Last Days of Pompeii,1984,2,0,1,1984,0
david wind,Co-Op,1987,3,0,2,1984,3
dawn atkins,"Lipstick On His Collar (Harlequin Temptation, No. 895)",2002,2,0,7,2002,0
dawn atkins,"Room   But Not Bored! (Harlequin Temptation, 945)",2003,3,0,3,2002,1
dawn atkins,"Friendly Persuasion (Blaze, Book 93)",2003,4,2,12,2003,0
dawn atkins,Wedding for One / Tattoo for Two,2003,5,4.6,5,2003,0
dawn atkins,"A Perfect Life? (Harlequin Flipside, No. 11)",2004,6,3.5454545454545454,11,2003,1
dayton ward,A Time to Sow (Star Trek The Next Generation),2004,2,0,2,2003,1
dayton ward,Foundations (Star Trek: S.C.E.),2004,3,1.5,4,2004,0
dayton ward,A Time to Harvest (Star Trek The Next Generation),2004,4,0,2,2004,0
dean devlin,StarGate: A Novel,1994,2,3.111111111111111,9,1994,0
dean devlin,Independence Day,1996,3,2.3636363636363638,22,1994,2
dean devlin,Independence Day: Silent Zone,1997,4,0,2,1996,1
dean devlin,Independence Day: Silent Zone,1998,5,1.4,10,1997,1
dean devlin,Stargate: la puerta del tiempo,1998,6,0,1,1998,0
dean devlin,"Independence Day #3 War in Desert (Independence Day, 4)",1999,7,0,4,1998,1
dean devlin,Stargate (G K Hall Large Print Science Fiction Series),1999,8,0,1,1999,0
dean edell,"Eat, Drink, &amp; Be Merry : America's Doctor Tells You Why the Health Experts Are Wrong",2000,2,4,2,1999,1
dean king,A Sea of Words: A Lexicon and Companion for Patrick O'Brian's Seafaring Tales,1997,2,0,1,1995,2
dean king,Cancer Combat: Cancer Survivors Share Their Guerrilla Tactics to Help You Win the Fight of Your Life,1998,3,0,2,1997,1
dean king,"Harbors and High Seas, 3rd Edition : An Atlas and Georgraphical Guide to the Complete Aubrey-Maturin Novels of Patrick O'Brian, Third Edition",2000,4,4.5,2,1998,2
dean king,"A Sea of Words, Third Edition: A Lexicon and Companion to the Complete Seafaring Tales of Patrick O'Brian",2000,5,9,2,2000,0
dean king,Patrick O'Brian :  A Life Revealed,2000,6,0,2,2000,0
dean king,Skeletons on the Zahara: A True Story of Survival,2004,7,2,5,2000,4
deanna f. cook,FamilyFun Crafts: 500 Creative Activities for You and Your Kids,1997,2,3,3,1996,1
deanna f. cook,"FamilyFun Boredom Busters:  365 Games, Crafts &amp; Activities For Every Day of the Year",2002,3,10,1,1997,5
debbie macomber,Borrowed Dreams (Silhouette Special Edition #241),1985,2,0,1,1985,0
debbie macomber,"Matchmakers (Harlequin Romance, 2768)",1986,3,1.2,5,1985,1
debbie macomber,"Love By Degree (Harlequin Romance, No. 2835)",1987,4,1.25,8,1986,1
debbie macomber,Mail-Order Bride (Silhouette Romance 539),1987,5,0,2,1987,0
debbie macomber,"Navy Wife (Silhouette Special Edition, No 494)",1988,6,4,2,1987,1
debbie macomber,"Sheriff Takes A Wife (Silhouette Special Edition, No 637)",1990,7,5,2,1988,2
debbie macomber,"Country Bride (Harlequin Romance, No 3059)",1990,8,1.25,4,1990,0
debbie macomber,"Rainy Day Kisses (Harlequin Romance, No 3076)",1990,9,2.5,4,1990,0
debbie macomber,"Courtship Of Carol Sommars (Harlequin Special Edition, No 606)",1990,10,0,1,1990,0
debbie macomber,"Little Bit Country (Harlequin Romance, 3038)",1990,11,0,2,1990,0
debbie macomber,"Navy Brat (Special Edition, No 662)",1991,12,2,1,1990,1
debbie macomber,"Forgetful Bride (Harlequin Romance, No. 3166)",1991,13,2.5,2,1991,0
debbie macomber,"Navy Baby (Silhouette Special Edition, No 697)",1991,14,0,2,1991,0
debbie macomber,"Navy Woman (Silhouette Special Edition, No 683)",1991,15,0,1,1991,0
debbie macomber,"Father'S Day (Harlequin Romance, No 3130)",1991,16,1.2,10,1991,0
debbie macomber,"Here Comes Trouble (Harlequin Romance, No 3148)",1991,17,0,3,1991,0
debbie macomber,"First Comes Marriage (Harlequin Romance, No 3113)",1991,18,5,1,1991,0
debbie macomber,The Sherriff Takes a Wife,1991,19,6,1,1991,0
debbie macomber,"Bride On The Loose (Silhouette Special Edition, No. 756)",1992,20,4,2,1991,1
debbie macomber,"Stand-In Wife (Silhouette Special Edition, No 9744)",1992,21,4.8,5,1992,0
debbie macomber,Christmas Treasures,1992,22,1.6666666666666667,3,1992,0
debbie macomber,"Norah: Orchard Valley Trilogy, Vol. 3 (Harlequin Romance, No 3244)",1992,23,0,2,1992,0
debbie macomber,Marriage of Inconvenience,1992,24,0,1,1992,0
debbie macomber,The Man You'll Marry,1992,25,0,1,1992,0
debbie macomber,"Valerie (Harlequin Romance, No 3232)",1992,26,1.6666666666666667,3,1992,0
debbie macomber,Morning Comes Softly (Harper Monogram),1993,27,1.6,5,1992,1
debbie macomber,Lone Star Lovin' (Back to the Ranch),1993,28,0,1,1993,0
debbie macomber,"Hasty Wedding (Silhouette Special Edition, No 9798)",1993,29,0,2,1993,0
debbie macomber,Borrowed Dreams  (Men Made In America) (Men Made in America),1993,30,0,3,1993,0
debbie macomber,"Groom Wanted (From This Day Forward) (Silhouette Special Edition, No 831)",1993,31,0,2,1993,0
debbie macomber,A Season of Angels (Harper Monogram),1993,32,2,11,1993,0
debbie macomber,"Bride Wanted (Silhouette Special Edition, No 836)",1993,33,2.3333333333333335,3,1993,0
debbie macomber,"Ready For Romance (Harlequin Romance, 3288)",1993,34,1,5,1993,0
debbie macomber,Men In Uniform (By Request Series) (By Request),1994,35,0,1,1993,1
debbie macomber,One Night,1994,36,4.375,8,1994,0
debbie macomber,"Baby Blessed (That Special Woman!, 50th Book) (Silhouette Special Edition, No 9895)",1994,37,0,1,1994,0
debbie macomber,Morning Comes Softly (Thorndike Large Print Popular),1994,38,8,1,1994,0
debbie macomber,The Trouble with Angels,1994,39,2.375,8,1994,0
debbie macomber,"Bachelor Prince (Celebration 1000!) (Silhouette Romance, No 1012)",1994,40,0,3,1994,0
debbie macomber,"Ready For Marriage (Harlequin Romance, No 3307)",1994,41,0,3,1994,0
debbie macomber,Purrfect Love (Harper Monogram),1994,42,1,5,1994,0
debbie macomber,"Just Married (Silhouette Special Edition, No 1003)",1995,43,0,1,1994,1
debbie macomber,Promise Me Forever,1995,44,1.1538461538461537,26,1995,0
debbie macomber,"Brides For Brothers (Harlequin Romance, No 3379)",1995,45,0,1,1995,0
debbie macomber,Touched by Angels,1995,46,0.625,8,1995,0
debbie macomber,Reflections of Yesterday,1995,47,2,3,1995,0
debbie macomber,Starlight,1995,48,3.5,2,1995,0
debbie macomber,Legendary Lovers (By Request) (3 Novels in 1),1995,49,2.5555555555555554,9,1995,0
debbie macomber,"Same Time, Next Year (That Special Woman) (Silhouette Special Edition, No 937)",1995,50,1.75,4,1995,0
debbie macomber,Wanted: Perfect Partner (Yours Truly #1) (Silhouette Yours Truly),1995,51,3.3333333333333335,3,1995,0
debbie macomber,Someday Soon,1995,52,0.875,8,1995,0
debbie macomber,"Daddy'S Little Helper (Midnight Sons) (Harlequin Romance : Midnight Sons, No 3387)",1995,53,2.75,4,1995,0
debbie macomber,Marriage Risk (Midnight Sons) (Harlequin Romance),1995,54,1.6,5,1995,0
debbie macomber,Sooner or Later,1996,55,1.75,4,1995,1
debbie macomber,Home For Christmas (By Request) (Harlequin by Request),1996,56,2.6666666666666665,3,1996,0
debbie macomber,For All My Tomorrows,1996,57,0,5,1996,0
debbie macomber,"Ending In Marriage (Midnight Sons) (Harlequin Romance, No 3403)",1996,58,0,1,1996,0
debbie macomber,Fallen Angel,1996,59,2,7,1996,0
debbie macomber,Falling For Him (Midnight Sons) (Harlequin Romance No 3399),1996,60,0,5,1996,0
debbie macomber,Because Of The Baby (Midnight Sons),1996,61,0,1,1996,0
debbie macomber,Mrs. Miracle,1996,62,3.6,5,1996,0
debbie macomber,Playboy And The Widow,1996,63,5,1,1996,0
debbie macomber,Runaway Brides (By Request),1996,64,1.5,6,1996,0
debbie macomber,Because of the Baby (Thorndike Large Print Harlequin Series),1997,65,0,2,1996,1
debbie macomber,Shadow Chasing,1997,66,0,4,1997,0
debbie macomber,This Matter Of Marriage,1997,67,1.7173913043478262,46,1997,0
debbie macomber,Denim And Diamonds,1997,68,0.8,10,1997,0
debbie macomber,"Three Brides, No Groom",1997,69,1.6,15,1997,0
debbie macomber,The Marriage Risk (Thorndike Large Print Harlequin Series),1997,70,0,2,1997,0
debbie macomber,The Way to a Man's Heart (Enchanted),1997,71,5,1,1997,0
debbie macomber,Daddy's Little Helper (Thorndike Large Print Harlequin Series),1997,72,0,2,1997,0
debbie macomber,Montana,1997,73,0,1,1997,0
debbie macomber,Orchard Valley Weddings,1997,74,0,1,1997,0
debbie macomber,Yours And Mine,1997,75,0,3,1997,0
debbie macomber,Can This Be Christmas?  (Hardcover),1998,76,4,2,1997,1
debbie macomber,Nell's Cowboy,1998,77,3.6666666666666665,6,1998,0
debbie macomber,Moon over Water,1998,78,0,3,1998,0
debbie macomber,Country Brides: A Little Bit Country; Country Bride,1998,79,0,1,1998,0
debbie macomber,Lonesome Cowboy  (Heart Of Texas),1998,80,5,5,1998,0
debbie macomber,Sooner or Later,1998,81,0,1,1998,0
debbie macomber,Montana,1998,82,1.2307692307692308,52,1998,0
debbie macomber,"Texas Two - Step (Heart Of Texas) (Harlequin Romance, No 2)",1998,83,3.6,5,1998,0
debbie macomber,"Lone Star Baby  (Heart Of Texas) (Harlequin Promo , No 6)",1998,84,3,8,1998,0
debbie macomber,Montana,1998,85,9,1,1998,0
debbie macomber,"Dr Texas (Heart Of Texas) (Harlequin Promo , No 4)",1998,86,2.8181818181818183,11,1998,0
debbie macomber,Caroline'S Child (Heart Of Texas) (Power Trilogy),1998,87,2.142857142857143,7,1998,0
debbie macomber,Promise Texas,1999,88,0.75,16,1998,1
debbie macomber,Dr. Texas (Heart of Texas),1999,89,10,1,1999,0
debbie macomber,Shirley Goodness And Mercy  (Hardcover),1999,90,5,5,1999,0
debbie macomber,Moon Over Water,1999,91,0.21739130434782608,23,1999,0
debbie macomber,"Shirley, Goodness and Mercy",1999,92,1.6666666666666667,6,1999,0
debbie macomber,"Harlequin 50th Anniversary Collection #1 (Harlequin 50th Anniversary Collection, No 1)",1999,93,0.875,8,1999,0
debbie macomber,Orchard Valley,1999,94,1.375,8,1999,0
debbie macomber,Caroline's Child,2000,95,10,1,1999,1
debbie macomber,Holiday Blessings (Love Inspired Promo),2000,96,5,1,2000,0
debbie macomber,Mail-Order Marriages (Harlequin Promo),2000,97,1.8571428571428572,14,2000,0
debbie macomber,"Dakota Home (Dakota Trilogy, Book 2)",2000,98,2.3846153846153846,39,2000,0
debbie macomber,Return To Promise (Mira),2000,99,2.375,16,2000,0
debbie macomber,Nell's Cowboy (Harlequin Romance Audio),2000,100,2.6666666666666665,3,2000,0
debbie macomber,Return to Promise (Mira (Audio)),2000,101,0,1,2000,0
debbie macomber,Fallen Angel (Thorndike Large Print Americana Series),2000,102,7,1,2000,0
debbie macomber,Dakota Born,2000,103,0,1,2000,0
debbie macomber,"Dakota Born (Dakota Trilogy, Book 1)",2000,104,1.5714285714285714,42,2000,0
debbie macomber,The Playboy and the Widow (Thorndike Large Print Americana Series),2000,105,8,1,2000,0
debbie macomber,Last Two Bachelors,2000,106,3.5454545454545454,22,2000,0
debbie macomber,Country Brides,2000,107,1.75,4,2000,0
debbie macomber,Dakota Home (Mira (Audio)),2000,108,0,1,2000,0
debbie macomber,Promise,2000,109,8,1,2000,0
debbie macomber,"Family Men (Midnight Sons, Volume 2)",2000,110,3.4166666666666665,12,2000,0
debbie macomber,Born in a Small Town (Harlequin SuperRomance 936),2000,111,3.142857142857143,14,2000,0
debbie macomber,"Lone Star Baby (Macomber, Debbie. Heart of Texas (Grand Haven, Mich.).)",2000,112,8,1,2000,0
debbie macomber,Take 5 Volume 1 (Take 5),2001,113,3,4,2000,1
debbie macomber,The First Man You Meet / Jacob's Girls,2001,114,0,10,2001,0
debbie macomber,Harlequin Romance 2-In-1 Collection (Collector's Edition 2 in 1),2001,115,1.6,5,2001,0
debbie macomber,Thursdays At Eight,2001,116,2.6666666666666665,12,2001,0
debbie macomber,Ideal Marriage?,2001,117,1.8,10,2001,0
debbie macomber,16 Lighthouse Road,2001,118,1.9076923076923078,65,2001,0
debbie macomber,Always Dakota,2001,119,1.7241379310344827,29,2001,0
debbie macomber,Buffalo Valley,2001,120,1.5,12,2001,0
debbie macomber,Midnight Clear (3 Novels in 1),2001,121,1.1818181818181819,11,2001,0
debbie macomber,Ready For Love,2001,122,1.3333333333333333,6,2001,0
debbie macomber,A Gift To Last,2002,123,2.1666666666666665,42,2001,1
debbie macomber,Angels Everywhere: A Season of Angels/Touched by Angels (Avon Romance),2002,124,3.707317073170732,41,2002,0
debbie macomber,Thursday'S At Eight,2002,125,2.4444444444444446,72,2002,0
debbie macomber,204 Rosewood Lane,2002,126,1.704225352112676,71,2002,0
debbie macomber,The Christmas Basket,2002,127,2.2777777777777777,18,2002,0
debbie macomber,Darling Daughters,2002,128,1.1081081081081081,37,2002,0
debbie macomber,Between Friends,2002,129,6.857142857142857,7,2002,0
debbie macomber,Sealed With A Kiss,2002,130,1.5,10,2002,0
debbie macomber,311 Pelican Court,2003,131,2.9130434782608696,46,2002,1
debbie macomber,Changing Habits,2003,132,5.416666666666667,12,2003,0
debbie macomber,Navy Blues,2003,133,1.3636363636363635,22,2003,0
debbie macomber,The Snow Bride,2003,134,3.15,20,2003,0
debbie macomber,"Those Christmas Angels (Harlequin Superromance, 1164)",2003,135,1.837837837837838,37,2003,0
debbie macomber,This Matter Of Marriage,2003,136,0,3,2003,0
debbie macomber,Moon Over Water,2003,137,3.5,2,2003,0
debbie macomber,Navy Wife (Silhouette Romance),2003,138,2,33,2003,0
debbie macomber,"Promise, Texas",2003,139,9,1,2003,0
debbie macomber,311 Pelican Court,2003,140,8,1,2003,0
debbie macomber,Between Friends,2003,141,2.6626506024096384,83,2003,0
debbie macomber,Montana,2003,142,8,1,2003,0
debbie macomber,Navy Brat (Silhouette Single Title),2004,143,1.3636363636363635,11,2003,1
debbie macomber,Changing Habits (Mira),2004,144,2.033333333333333,30,2004,0
debbie macomber,The Shop On Blossom Street,2004,145,3.6363636363636362,11,2004,0
debbie macomber,Navy Woman (Silhouette Single Title),2004,146,1.1666666666666667,6,2004,0
debbie macomber,44 Cranberry Point,2004,147,4,2,2004,0
debby anderson,My Friend Noah (Cuddle and Sing),1988,2,2.6666666666666665,3,1988,0
debby anderson,Jesus loves the little childen (Cuddle and sing),1993,3,7,1,1988,5
debby slier,What Do Toddlers Do?,1985,2,0,2,1985,0
debby slier,Whose Baby Are You? (Matchem Board Books),1987,3,0,2,1985,2
debby slier,Hello Baby,1988,4,0,1,1987,1
debby slier,Baby's Words (Hello Baby Books),1988,5,5,1,1988,0
debby slier,Busy Baby (Hello Baby Books),1988,6,5,1,1988,0
debby slier,Baby's Place,1989,7,5,1,1988,1
debby slier,My 1st ABC (Storytime Books I),1990,8,0,1,1989,1
debby slier,Words I Know: Hello Baby Books (Hello Baby Books),1991,9,5,1,1990,1
debby slier,Babies Words (Hello Baby Books),1991,10,0,1,1991,0
debby slier,The Brementown Musicians (Read Along With Me),1993,11,0,1,1991,2
debby slier,Word Signs: A First Book of Sign Language,1995,12,0,1,1993,2
deborah camp,Fallen Angel,1989,2,5,1,1987,2
deborah camp,Black-Eyed Susan (Avon Romance Series),1990,3,0,1,1989,1
deborah camp,Fire Lily,1991,4,0,1,1990,1
deborah camp,Lady Legend,1992,5,7,1,1991,1
deborah camp,Master of Moonspell,1993,6,3.5,2,1992,1
deborah camp,Cheyenne's Shadow,1994,7,9,1,1993,1
deborah camp,Lonewolf's Woman,1995,8,0,1,1994,1
deborah camp,Too Tough to Tame,1996,9,2.5,2,1995,1
deborah camp,Tough Talk and Tender Kisses (Tough Man Series),1997,10,2.5,2,1996,1
deborah camp,"A Tough Man's Woman (Tough Man Series , No 3)",1997,11,4.5,2,1997,0
deborah chancellor,DK Readers: Holiday! Celebration Days Around the World (Level 2: Beginning to Read Alone),2000,2,8,1,2000,0
deborah chasman,Drawing Us in: Essays on How We Experience Visual Art : A Beacon Anthology (Beacon Anthology),2000,2,5,1,1999,1
deborah copaken kogan,Shutterbabe: Adventures in Love and War,2002,2,6.3076923076923075,13,2001,1
deborah ellis,Breadwinner,2001,2,3.2,10,2001,0
deborah ellis,The Bread Winner,2001,3,8.333333333333334,3,2001,0
deborah ellis,Parvana's Journey,2003,4,1.6666666666666667,6,2001,2
deborah ellis,Mud City,2004,5,0,2,2003,1
deborah felder,Changing Times: The Story of a Tennessee Walking Horse and the Girl Who Proves That Grown-Ups Don't Always Know Best (Treasured Horses),1998,2,0,1,1997,1
deborah felder,The 100 Most Influential Women of All Time: A Ranking Past and Present,1998,3,0,1,1998,0
deborah lawrence,Courting Sarah (Friends Romance Series),1999,2,3.3333333333333335,3,1997,2
deborah lipp,The Way of Four: Create Elemental Balance in Your Life,2004,2,10,1,2003,1
deborah nixon,Practical Art of Aromatherapy: Create Your Own Personalized Beauty Treatments and Natural Remedies,1996,2,0,1,1996,0
debra barracca,"Las Aventuras De Maxi, El Perro Taxitsta/Pigs Aplenty, Pigs Galore",1996,2,9,1,1990,6
debra magpie earling,Perma Red,2003,2,3.5,2,2002,1
debra monroe,"WILD, COLD STATE",1995,2,4,1,1995,0
debra monroe,NEW FANGLED : A NOVEL,1998,3,0,1,1995,3
debra monroe,Newfangled : A Novel,2000,4,0,2,1998,2
debra mullins,Donovan's Bed,2000,2,3.5,2,1999,1
debra mullins,The Lawman's Surrender,2001,3,1.75,4,2000,1
debra mullins,A Necessary Husband,2002,4,3.75,4,2001,1
debra mullins,A Necessary Bride,2003,5,3,3,2002,1
debra mullins,Three Nights...,2004,6,5.5,6,2003,1
debra st. claire,The Herbal Medicine Cabinet: Preparing Natural Remedies at Home,1997,2,5,1,1993,4
debra wasserman,"Vegan Handbook: Over 200 Delicious Recipes, Meal Plans, and Vegetarian Resources for All   Ages (Vegetarian Journal Reports Series, 2nd Bk.)",1996,2,9,1,1991,5
debra wasserman,Conveniently Vegan: Turn Packaged Foods into Delicious Vegetarian Dishes,1997,3,9,1,1996,1
debra wasserman,Meatless Meals for the Working People: Quick and Easy Vegetarian Recipes (Meatless Meals for Working People),1998,4,4,2,1997,1
dee brestin,The Joy of Eating Right!: Spiritual and Nutritional Principles for Weight Control ( a Bible Study for Women),1993,2,0,1,1988,5
dee brestin,"We Are Sisters: A Sequel to the Bestseller, the Friendships of Women",1996,3,0,1,1993,3
dee brestin,The Friendships of Women,1997,4,0,1,1996,1
dee brestin,Falling In Love With Jesus Abandoning Yourself To The Greatest Romance Of Your Life,2001,5,3.5,2,1997,4
dee brestin,Falling In Love With Jesus Abandoning Yourself To The Greatest Romance Of Your Life,2002,6,4.5,2,2001,1
deirdre mcnamer,One Sweet Quarrel: A Novel,1995,2,0,3,1994,1
deirdre mcnamer,My Russian,1999,3,2,3,1995,4
deirdre mcnamer,My Russian (Ballantine Reader's Circle),2000,4,1.1111111111111112,9,1999,1
deirdre purcell,That Childhood Country,1994,2,2,4,1993,1
deirdre purcell,Ashes of Roses,1994,3,0,4,1994,0
deirdre purcell,Falling for a Dancer,1994,4,2.5,2,1994,0
deirdre purcell,Roses After Rain,1996,5,0,1,1994,2
deirdre purcell,Flammen der Erinnerung.,1998,6,7,1,1996,2
deirdre purcell,Love Like Hate Adore,1998,7,2.25,8,1998,0
deirdre purcell,Marble Gardens,2003,8,0,2,1998,5
della rowland,A World of Dogs,1990,2,0,1,1989,1
della rowland,Whales &amp; dolphins (Explorer books),1991,3,0,2,1990,1
della rowland,Christmas : A Holiday Treasury,1994,4,0,1,1991,3
della rowland,The Case of the Mystery Ghost (Clue Jr.),1996,5,0,1,1994,2
della rowland,The Case of the Barking Dog (Case of the Barking Dog),1997,6,5,1,1996,1
denise bieniek,Math Power: How to Get A's in Math,1999,2,0,1,1996,3
denise clark pope,"Doing School\: How We Are Creating a Generation of Stressed Out, Materialistic, and Miseducated Students""""",2003,2,7,1,2001,2
denise hamilton,The Jasmine Trade,2002,2,1.1111111111111112,18,2001,1
denise hamilton,Sugar Skull: An Eve Diamond Novel,2003,3,9,1,2002,1
denise hamilton,Sugar Skull : An Eve Diamond Novel (Eve Diamond Novels),2004,4,3.3,10,2003,1
denise hamilton,Last Lullaby : An Eve Diamond Novel (Eve Diamond Novels),2004,5,5,2,2004,0
denise lardner carmody,Mythological Woman: Contemporary Reflections on Ancient Stories,1993,2,5,1,1991,2
denise lardner carmody,Mysticism: Holiness East and West,1995,3,7,1,1993,2
denise noel,"Two Faces of Love (Mystique Books, 25)",1979,2,0,1,1977,2
denise robertson,Daybreak,1996,2,0,1,1993,3
denise robertson,Das GlÃ?Â¼ck der Freiheit. Roman.,1998,3,2.5,2,1996,2
denise robertson,Illusion,1999,4,0,1,1998,1
denise robertson,SchÃ?Â¶ne Welt am Morgen.,1999,5,0,1,1999,0
dennis byrd,Rise &amp; Walk: The Trial &amp; Triumph of Dennis Byrd (Harperspotlight),1994,2,0,3,1993,1
dennis cooper,Closer,1990,2,7,1,1989,1
dennis cooper,Frisk,1991,3,0,1,1990,1
dennis cooper,Frisk,1992,4,0.8,5,1991,1
dennis cooper,TRY,1995,5,0,1,1992,3
dennis cooper,Closer,1995,6,8,1,1995,0
dennis cooper,Guide,1997,7,7,1,1995,2
dennis cooper,Guide,1998,8,7,1,1997,1
dennis cooper,Guide,1998,9,8,1,1998,0
dennis cooper,All Ears,1999,10,0,1,1998,1
dennis foon,Double or Nothing,2000,2,0,1,1989,11
dennis foon,"The Dirt Eaters (Longlight Legacy, 1)",2003,3,0,2,2000,3
dennis jones,Russian Spring,1986,2,0,3,1985,1
dennis jones,Barbarossa Red,1989,3,0,2,1986,3
dennis jones,Winter Palace,1989,4,0,4,1989,0
dennis jones,Concerto,1990,5,0,1,1989,1
dennis jones,Warsaw Concerto,1990,6,0,1,1990,0
dennis jones,Concerto,1991,7,0,3,1990,1
dennis jones,The Stone and the Maiden (House of Pandragore),1999,8,2,4,1991,8
dennis jones,"The Stone and the Maiden (House of the Pandragore, Book 1)",2000,9,0,2,1999,1
dennis jones,"The Mask and the Sorceress (House of the Pandragore, Book 2)",2001,10,9,1,2000,1
dennis jones,The Mask and the Sorceress : The House of the Pandragore,2002,11,0,1,2001,1
dennis mckiernan,"Into the Fire (Hel's Crucible Duology, 2)",1999,2,1.6666666666666667,6,1985,14
dennis mckiernan,The Iron Tower: The Dark Tide/Shadows of Doom/the Darkest Day,2000,3,0,3,1999,1
dennis rainey,"Lonely Husbands, Lonely Wives: Rekindling Intimacy in Every Marriage (Homebuilders couples series)",1989,2,0,1,1986,3
dennis rainey,Moments Together for Couples,1995,3,0,4,1989,6
dennis rainey,Building Your Mate's Self-esteem,1995,4,6,1,1995,0
dennis rainey,One Home at a Time: Restoring the Soul of America Through God's Plan for Your Marriage and Family,1998,5,0,1,1995,3
dennis rainey,Simply Romantic Ideas: 150 Fun and Creative Ways to Romance Your Wife,1999,6,0,1,1998,1
dennis rainey,Starting Your Marriage Right &lt;i>what You Need To Know In The Early Years To Make It Last A Lifetime&lt;/i>,2000,7,0,1,1999,1
dennis rainey,"Growing a Spiritually Strong Family (The Family First series, book one)",2002,8,0,1,2000,2
dennis rainey,"So You Want To Be A Teenager? What Every Preteen Must Know About Friends, Love, Sex, Dating, And Other Life Issues",2002,9,0,1,2002,0
dennis rainey,Two Hearts Praying As One (Family First),2003,10,0,1,2002,1
dennis smith,Firefighters: Their Lives in Their Own Words,1988,2,2.6666666666666665,3,1987,1
dennis smith,Firefighters: Their Lives in Their Own Words,1989,3,0,1,1988,1
dennis smith,Report from Engine Co. 82,1999,4,8,1,1989,10
dennis smith,A Song for Mary: An Irish-American Memory,1999,5,4.5,2,1999,0
dennis smith,Report From Engine Co. 82,1999,6,8,1,1999,0
dennis smith,A Song for Mary : An Irish-American Memory,2000,7,4,2,1999,1
dennis smith,Report from Engine Co. 82 (G K Hall Large Print Paperback Series),2001,8,0,1,2000,1
dennis smith,Report from Ground Zero: The Story of the Rescue Efforts at the World Trade Center,2002,9,3.7333333333333334,15,2001,1
dennis smith,Report from Ground Zero,2003,10,4.25,4,2002,1
derek lambert,The Red Dove,1983,2,0,1,1979,4
derek lambert,The Golden Express,1985,3,0,2,1983,2
derek lambert,Spanish Lessons,2000,4,0,1,1985,15
derek lambert,Spanish Lessons : Beginning a New Life in Spain,2001,5,4,7,2000,1
derek parker,Atlas of the Supernatural,1990,2,5,1,1985,5
dervla murphy,The Waiting Land: A Spell in Nepal,1990,2,0,3,1987,3
dervla murphy,South from the Limpopo: Travels Through South Africa,2001,3,6.5,6,1990,11
devin j. starlanyl,"Worlds of Power, Lines of Light",1999,2,0,1,1996,3
devin j. starlanyl,Fibromyalgia and Chronic Myofascial Pain: A Survival Manual (2nd Edition),2001,3,10,1,1999,2
dexter yager,Storms of Perfection 1: In Their Own Words,1991,2,10,1,1990,1
dexter yager,"Ordinary Men, Extraordinary Heroes",1992,3,2,2,1991,1
dharma singh khalsa,The Pain Cure: The Proven Medical Program That Helps End Your Chronic Pain,1999,2,7,1,1997,2
dharma singh khalsa,"Food As Medicine: How to Use Diet, Vitamins, Juices, and Herbs for a Healthier, Happier, and Longer Life",2003,3,0,2,1999,4
dian curtis regan,My Zombie Valentine,1993,2,8,1,1990,3
dian curtis regan,The Vampire Who Came for Christmas,1994,3,0,1,1993,1
dian curtis regan,Home for the Howl-idays,1994,4,0,4,1994,0
dian curtis regan,"The Mystery at Kickingbird Lake (Ghost Twins, No 1)",1994,5,0,4,1994,0
dian curtis regan,"The Mystery of One Wish Pond (Ghost Twins, No 2)",1994,6,0,2,1994,0
dian curtis regan,The Mystery at Kickingbird Lake (Ghost Twins S.),1995,7,0,1,1994,1
dian curtis regan,"The Mystery of the Haunted Castle (Ghost Twins, No 8)",1995,8,4,2,1995,0
dian curtis regan,Monster of the Month Club,1995,9,2.5,2,1995,0
dian curtis regan,"The Mystery on Walrus Mountain (Ghost Twins Book, No 3)",1995,10,0,1,1995,0
dian curtis regan,Princess Nevermore,1995,11,7,1,1995,0
dian curtis regan,"The Mystery of the Disappearing Dogs (Ghost Twins, No 5)",1995,12,0,1,1995,0
dian curtis regan,Princess Nevermore (Point Fantasy),1997,13,4,8,1995,2
dian curtis regan,Fangs-Giving,1997,14,0,2,1997,0
diana atkinson,Highways and Dancehalls: A Novel,1997,2,0,2,1996,1
diana gregory,"Two's a Crowd (Sweet Dreams, 90)",1985,2,5,1,1984,1
diana gregory,"Promises Broken (Caitlin: The Promise Trilogy, Book 2)",1986,3,0.7142857142857143,7,1985,1
diana mcclun,Q Is for Quilt,2002,2,10,1,1998,4
diane carey,Final Frontier (Star Trek),1988,2,1,7,1988,0
diane carey,FINAL FRONTIER (CLASSIC STAR TREK ) (Star Trek Novel),1989,3,0,2,1988,1
diane carey,Sudden Storm (Evans Novel of Romance),1990,4,5,1,1989,1
diane carey,Star Trek Giant 3: Final Frontier,1991,5,7,1,1990,1
diane carey,"Ghost Ship (Star Trek The Next Generation, No 1)",1991,6,1.9166666666666667,12,1991,0
diane carey,Rose Legacy,1992,7,10,1,1991,1
diane carey,Best Destiny (Star Trek),1992,8,2.5714285714285716,7,1992,0
diane carey,Descent (Star Trek: The Next Generation),1993,9,3.466666666666667,15,1992,1
diane carey,"The Great Starship Race (Star Trek, Book 67)",1993,10,2.625,8,1993,0
diane carey,Best Destiny (Star Trek),1993,11,2.6666666666666665,18,1993,0
diane carey,Gespensterschiff / Planet des Untergangs / Die Augen der Betrachter. Star Trek.,1994,12,4.25,4,1993,1
diane carey,The Search (Star Trek Deep Space Nine),1994,13,0,5,1994,0
diane carey,"Station Rage (Star Trek Deep Space Nine, No 13)",1995,14,4.166666666666667,6,1994,1
diane carey,The Way of the Warrior (Star Trek Deep Space Nine),1995,15,3.2,5,1995,0
diane carey,"First Frontier (Star Trek, Book 75)",1995,16,2.3636363636363638,11,1995,0
diane carey,Flashback (Star Trek: Voyager),1996,17,2,6,1995,1
diane carey,"Invasion #1: First Strike (Star Trek, Book 79)",1996,18,1.7142857142857142,14,1996,0
diane carey,Ship of the Line (Star Trek: The Next Generation),1997,19,0.375,8,1996,1
diane carey,Ancient Blood:  Day of Honor #1 (Star Trek The Next Generation),1997,20,1.7142857142857142,14,1997,0
diane carey,Starfleet Academy (Star Trek: All),1997,21,0,1,1997,0
diane carey,Call to Arms...:  The Dominion War Book 2 (Star Trek Deep Space Nine),1998,22,0,8,1997,1
diane carey,...Sacrifice of Angels:  The Dominion War Book 4 (Star Trek Deep Space Nine),1998,23,0,5,1998,0
diane carey,"Fire Ship (Star Trek Voyager: The Captains Table, Book 4)",1998,24,3.3846153846153846,13,1998,0
diane carey,"Red Sector (Star Trek The Next Generation: Double Helix, Book 3)",1999,25,2.111111111111111,9,1998,1
diane carey,"Battlestations! (Star Trek, No 31)",1999,26,2,3,1999,0
diane carey,Equinox (Star Trek Voyager),1999,27,4.666666666666667,3,1999,0
diane carey,Ship of the Line (Star Trek: The Next Generation),1999,28,2.857142857142857,7,1999,0
diane carey,Day Of Honor Omnibus,1999,29,3.6666666666666665,3,1999,0
diane carey,What You Leave Behind (Star Trek Deep Space Nine),1999,30,4,2,1999,0
diane carey,"Dreadnought! (Star Trek, No 29)",1999,31,0,3,1999,0
diane carey,"Wagon Train to the Stars (Star Trek No 89, New Earth Book One of Six)",2000,32,0,2,1999,1
diane carey,"Challenger (Star Trek, New Earth, Book 6)",2000,33,3,2,2000,0
diane carey,Gateways #7:  What Lay Beyond (Star Trek),2001,34,7,1,2000,1
diane carey,Endspiel. Roman zum groÃ?Â?en Finale von Star Trek- Voyager.,2001,35,0,1,2001,0
diane carey,Gateways #2:  Chainmail (Star Trek/Challenger),2001,36,0.3333333333333333,3,2001,0
diane carey,Gateways #7:  What Lay Beyond (Star Trek),2002,37,2.2,5,2001,1
diane carey,Broken Bow (Star Trek Enterprise),2003,38,0,1,2002,1
diane carey,S.W.A.T.,2003,39,5.5,2,2003,0
diane guest,Lullaby,1991,2,0,2,1986,5
diane guest,Forbidden Garden,1993,3,0,2,1991,2
diane johnson,Shadow Knows,1982,2,0,1,1980,2
diane johnson,Persian Nights: A Novel,1987,3,0,2,1982,5
diane johnson,Persian Nights,1988,4,0,2,1987,1
diane johnson,Health and Happiness,1991,5,0,2,1988,3
diane johnson,Natural Opium: Some Travelers' Tales,1993,6,7,1,1991,2
diane johnson,Le Divorce (William Abrahams Book),1997,7,2.6451612903225805,62,1993,4
diane johnson,Le Divorce,1997,8,2,10,1997,0
diane johnson,Burning,1998,9,1.75,4,1997,1
diane johnson,Lying Low (William Abrahams Book),1998,10,2.375,8,1998,0
diane johnson,Persian Nights (William Abrahams Book),1998,11,4,2,1998,0
diane johnson,The Shadow Knows (William Abrahams Book),1998,12,0,2,1998,0
diane johnson,Health and Happiness,1998,13,0,2,1998,0
diane johnson,Le Mariage,2000,14,0.782608695652174,23,1998,2
diane johnson,Le Mariage,2001,15,2.1621621621621623,37,2000,1
diane johnson,Divorcio a la francesa,2003,16,5,1,2001,2
diane johnson,L'Affaire,2003,17,0.8571428571428571,7,2003,0
diane johnson,Le Divorce (William Abrahams Book),2003,18,2.6818181818181817,22,2003,0
diane johnson,L'affaire,2004,19,10,1,2003,1
diane l. carey,BATTLESTATIONS 31 (Star Trek (Numbered Paperback)),1986,2,0.7142857142857143,7,1986,0
diane l. carey,BATTLESTATIONS 31 (Star Trek (Numbered Paperback)),1988,3,0,2,1986,2
diane l. carey,BATTLESTATIONS (ST #31) (Star Trek (Numbered Paperback)),1989,4,1.7142857142857142,7,1988,1
diane l. carey,Star Trek Best Destiny,1995,5,0,2,1989,6
diane mccarty,Basset Hounds,1989,2,9,1,1981,8
diane mccarty,Great Danes,1998,3,0,1,1989,9
diane mckinney-whetstone,TUMBLING,1997,2,2.875,8,1996,1
diane mckinney-whetstone,Tempest Rising,1998,3,3.5,2,1997,1
diane mckinney-whetstone,Blues Dancing: A Novel,1999,4,8,2,1998,1
diane mckinney-whetstone,Tempest Rising,1999,5,2.5,2,1999,0
diane mckinney-whetstone,"Leaving Cecil Street (Mckinneywhetstone, Diane)",2004,6,4.5,2,1999,5
diane molleson,The Secret Garden: With Key,1993,2,3.75,4,1993,0
diane molleson,A Little Princess,1995,3,3.5,2,1993,2
diane molleson,My Anastasia Storybook &amp; Necklace: With Key Charm,1997,4,9,1,1995,2
diane mott davidson,Dying for Chocolate (Culinary Mysteries (Hardcover)),1992,2,2.6,15,1990,2
diane mott davidson,Dying for Chocolate (Culinary Mysteries (Paperback)),1993,3,2.4864864864864864,111,1992,1
diane mott davidson,The Cereal Murders: A Culinary Mystery,1993,4,4.2727272727272725,11,1993,0
diane mott davidson,The Last Suppers,1994,5,1.8888888888888888,9,1993,1
diane mott davidson,The Cereal Murders,1994,6,2.1219512195121952,82,1994,0
diane mott davidson,Catering to Nobody,1995,7,3.2285714285714286,70,1994,1
diane mott davidson,The Last Suppers,1995,8,3.6285714285714286,70,1995,0
diane mott davidson,Killer Pancake: A Culinary Mystery,1995,9,1.3333333333333333,6,1995,0
diane mott davidson,Killer Pancake,1996,10,2.676470588235294,68,1995,1
diane mott davidson,Dying for Chocolate (Culinary Mysteries (Audio)),1996,11,3,2,1996,0
diane mott davidson,The Main Corpse,1996,12,4.2105263157894735,19,1996,0
diane mott davidson,The Main Corpse (Culinary Mysteries (Paperback)),1997,13,3.283582089552239,67,1996,1
diane mott davidson,The Grilling Season,1997,14,2.8,10,1997,0
diane mott davidson,Ein Mann zum Dessert. Ein Goldy Bear- Krimi.,1998,15,6,1,1997,1
diane mott davidson,Prime Cut,1998,16,2.9411764705882355,17,1998,0
diane mott davidson,The Grilling Season,1998,17,2.8095238095238093,84,1998,0
diane mott davidson,Mord a la carte.,1999,18,2.3333333333333335,3,1998,1
diane mott davidson,Tough Cookie,2000,19,1.8421052631578947,19,1999,1
diane mott davidson,Dying for Chocolate: A Culinary Mystery (Culinary Mysteries (Audio)),2000,20,3.5,2,2000,0
diane mott davidson,The Last Suppers: A Culinary Mystery (Culinary Mysteries (Audio)),2000,21,6,1,2000,0
diane mott davidson,Harte Nuss.,2000,22,0,1,2000,0
diane mott davidson,Prime Cut,2000,23,2.8625,80,2000,0
diane mott davidson,Killer Pancake: A Culinary Mystery (Culinary Mystery),2001,24,7,1,2000,1
diane mott davidson,The Main Corpse: A Culinary Mystery (Culinary Mystery),2001,25,3.5,2,2001,0
diane mott davidson,The Cereal Murders (Culinary Mystery),2001,26,5,3,2001,0
diane mott davidson,Tough Cookie,2001,27,2.5681818181818183,88,2001,0
diane mott davidson,Catering to Nobody (Culinary Mystery),2001,28,0,1,2001,0
diane mott davidson,Sticks and Scones,2001,29,5.333333333333333,3,2001,0
diane mott davidson,Sticks &amp; Scones,2001,30,4.111111111111111,27,2001,0
diane mott davidson,Man nehme: eine Leiche. Kriminalroman.,2001,31,0,1,2001,0
diane mott davidson,3 Culinary Mysteries: An Audio Book Trilogy of Best Sellers : Dying for Chocolate/Catering to Nobody/the Last Suppers,2002,32,4.5,2,2001,1
diane mott davidson,Chopping Spree,2002,33,4.090909090909091,33,2002,0
diane mott davidson,Sticks &amp; Scones,2002,34,3.1648351648351647,91,2002,0
diane mott davidson,Catering to Nobody,2002,35,3.475,40,2002,0
diane mott davidson,"Diane Mott Davidson: Dying for Chocolate, Catering to Nobody, the Last Suppers",2003,36,0,1,2002,1
diane mott davidson,"Chopping Spree (Goldy Bear Culinary Mystery, 11)",2003,37,0,1,2003,0
diane mott davidson,Chopping Spree,2003,38,2.982142857142857,56,2003,0
diane mott davidson,Double Shot,2004,39,3,2,2003,1
diane pershing,"Heartquake (Loveswept, No 659)",1993,2,0,1,1992,1
diane pershing,"Tough Guy And The Toddler  (Men In Blue) (Silhouette Intimate Moments, 928)",1999,3,0,5,1993,6
diane pershing,"Hot Copy/From Caviar to Chaos (Duets, 24)",2000,4,0.8333333333333334,6,1999,1
diane pershing,"Cassie's Cowboy (Soulmates) (Silhouette Romance, No. 1584)",2002,5,0,1,2000,2
diane pershing,The Wish  (Soulmates),2003,6,2.8,5,2002,1
diane pershing,"Ransom (Silhouette Romance, 1688)",2003,7,0,2,2003,0
diane pugh,Foolproof (Iris Thorne Mysteries),1999,2,2,3,1994,5
diane rossen worthington,The Taste of Summer: Inspired Recipes for Casual Entertaining,1988,2,2.5,2,1983,5
diane rossen worthington,Potatoes (Williams-Sonoma Kitchen Library),1994,3,0,1,1988,6
diane rossen worthington,Stir-Fry (Williams-Sonoma Kitchen Library),1994,4,0,1,1994,0
diane rossen worthington,The Williams-Sonoma Collection: Soup (Williams Sonoma Collection),2001,5,10,1,1994,7
diane stein,"The Women's Book of Healing: Crystals and Gemstones, Auras and Laying on of Hands, Chakras and Colors (Llewellyn's New Age Series)",1987,2,7,1,1986,1
diane stein,Casting the Circle: A Women's Book of Ritual,1990,3,4,3,1987,3
diane stein,The Goddess celebrates: An anthology of women's rituals,1991,4,0,2,1990,1
diane stein,"Dreaming the Past, Dreaming the Future: A Herstory of the Earth",1991,5,5,1,1991,0
diane stein,The Goddess Celebrates: An Anthology of Women's Rituals,1991,6,6,1,1991,0
diane stein,The Natural Remedy Book for Women,1992,7,7,1,1991,1
diane stein,Natural Healing for Dogs and Cats,1993,8,3.3333333333333335,3,1992,1
diane stein,Essential Reiki: A Complete Guide to an Ancient Healing Art,1995,9,5.333333333333333,3,1993,2
diane stein,On Grief and Dying: Understanding the Soul's Journey,1996,10,0,1,1995,1
diane stein,Healing With Flower and Gemstone Essences (Healing Series),1997,11,0,1,1996,1
diane stein,All Women Are Psychics,1999,12,0,1,1997,2
diane wagner,Corpus Delicti,1987,2,5,1,1986,1
diane zahler,21st Century Guide to Improving Your Writing (21st Century Reference),1995,2,5,1,1993,2
dianne hales,Pregnancy and Birth (The Encyclopedia of Heath),1989,2,0,1,1984,5
dianne redmond,Bob the Builder: Bob on the Run (Bob the Builder Story Book),2001,2,0,1,2001,0
dianne young,Honey Trouble,2002,2,7,1,2000,2
dicey deere,The Irish Cottage Murder (Torrey Tunet Mysteries (Paperback)),2000,2,0.6,5,1999,1
dicey deere,The Irish Manor House Murder,2000,3,7,2,2000,0
dicey deere,The Irish Manor House Murder,2001,4,1,5,2000,1
dicey deere,The Irish Cairn Murder : A Torrey Tunet Mystery (A Torrey Tuney Mystery),2003,5,2.2,5,2001,2
dicey deere,The Irish Village Murder (Torrey Tunet Mysteries (Hardcover)),2004,6,6,1,2003,1
dick cluster,Return to Sender (Penguin Crime Fiction),1989,2,0,2,1979,10
dick eastman,The Hour That Changes the World,1986,2,0,2,1973,13
dick j. reavis,Texas (Fodor's Compass American Guides),1995,2,0,1,1995,0
didier van cauwelaert,Cheyenne,1995,2,0,1,1994,1
didier van cauwelaert,Un aller simple,1995,3,4,6,1995,0
didier van cauwelaert,La vie interdite: Roman,1997,4,8,1,1995,2
didier van cauwelaert,Les vacances du fantÃ?Â´me,1997,5,3,2,1997,0
didier van cauwelaert,La Vie interdite,1999,6,0,1,1997,2
didier van cauwelaert,Corps Ã?Â©tranger,2000,7,0,1,1999,1
didier van cauwelaert,La Demi-pensionnaire,2001,8,4.5,2,2000,1
didier van cauwelaert,La educaciÃ³n de un hada,2001,9,4,2,2001,0
didier van cauwelaert,L'Education d'une fÃ?Â©e,2002,10,4.533333333333333,15,2001,1
didier van cauwelaert,Auf Seelenspitzen.,2002,11,7,1,2002,0
didier van cauwelaert,L'Apparition,2003,12,4,2,2002,1
didier van cauwelaert,Hors de moi,2003,13,7,1,2003,0
dieter bohlen,Nichts als die Wahrheit.,2003,2,5,2,2002,1
dino buzzati,La Fameuse Invasion de la Sicile par les ours,1999,2,10,1,1998,1
dino buzzati,Le K,2002,3,8,3,1999,3
dionne brand,At the Full and Change of the Moon,2000,2,8,1,1989,11
dirk fletcher,Dodge City Doll/Laramie Lovers (Spur Double Edition),1992,2,0,1,1984,8
dirk fletcher,"Savage Sisters (Spur, 14)",2004,3,0,1,1992,12
dirk wittenborn,Fierce People,2003,2,2.3333333333333335,3,2002,1
dixie lee mckeone,The Spider's Test (Birthright),1996,2,4,2,1996,0
dixie lee mckeone,Tales of Uncle Trapspringer (Dragonlance),1998,3,2,5,1996,2
docia schultz williams,When Darkness Falls: Tales of San Antonio Ghosts and Hauntings,1997,2,0,1,1992,5
domenic stansberry,Chasing the Dragon,2004,2,10,1,1990,14
don colbert,"Allergies: Ancient Truths, Natural Remedies &amp; the Latest Findings for Your Health Today (Bible Cure (Siloam))",2000,2,2,1,1999,1
don colbert,The Bible Cure for Weight Loss and Muscle Gain (Bible Cure (Siloam)),2000,3,8.5,2,2000,0
don colbert,The Bible Cure for ADD and Hyperactivity,2001,4,0,1,2000,1
don coldsmith,"BUFFALO MEDICINE (Spanish Bit Saga Book, No 4)",1987,2,2.8333333333333335,6,1987,0
don coldsmith,"Trail of the Spanish Bit : Spanish Bit Saga, Number 1 (Spanish Bit Saga of the Plains Indians)",1987,3,4.357142857142857,14,1987,0
don coldsmith,Man Of The Shadows (Spanish Bit #5),1988,4,6.6,5,1987,1
don coldsmith,"Pale Star (Spanish Bit Saga, No 9)",1988,5,0,2,1988,0
don coldsmith,"The Sacred Hills (Spanish Bit 72 Saga Book, No 8)",1988,6,0,1,1988,0
don coldsmith,"River of Swans (Spanish Bit Saga, No 10)",1989,7,5.666666666666667,3,1988,1
don coldsmith,"The Smoky Hill (Rivers West, Book 2)",1989,8,7,1,1989,0
don coldsmith,"Return to the River (Spanish Bit Saga Book, No 11)",1989,9,5,2,1989,0
don coldsmith,Changing Wind (Spanish Bit Saga of the Plains Indians Super Edition),1990,10,2.5,4,1989,1
don coldsmith,Trail from Taos (The Spanish Bit Saga Book 14),1990,11,2.6666666666666665,6,1990,0
don coldsmith,"FLOWER IN THE MOUNTAINS, THE (Spanish Bit Saga, Book No 13)",1990,12,5,2,1990,0
don coldsmith,Song of the Rock (Spanish Bit Saga of the Plains Indians),1991,13,5,2,1990,1
don coldsmith,"Follow the Wind (Spanish Bit Saga Book, No 3)",1991,14,4.125,8,1991,0
don coldsmith,The Traveler (Spanish Bit Saga of the Plains Indians Super Edition),1991,15,4.25,4,1991,0
don coldsmith,"Fort De Chastaigne (Spanish Bit Saga Book, No 16)",1991,16,0,3,1991,0
don coldsmith,Moon of Thunder (Spanish Bit Saga of the Plains Indians),1991,17,4.5,6,1991,0
don coldsmith,Daughter of the Eagle (Spanish Bit Saga Ser. Bk 6),1991,18,3.888888888888889,9,1991,0
don coldsmith,"The Medicine Knife (The Spanish Bit Saga, No 12)",1991,19,5,2,1991,0
don coldsmith,Quest for the White Bull (Spanish Bit Saga of the Plains Indians),1992,20,0,2,1991,1
don coldsmith,World of Silence (Spanish Bit Saga of the Plains Indians Super Edition),1992,21,0,3,1992,0
don coldsmith,Bride of the Morning Star (Spanish Bit Saga of the Plains Indians),1993,22,0,2,1992,1
don coldsmith,Walks in the Sun (Spanish Bit Saga of the Plains Indians),1993,23,3.3333333333333335,3,1993,0
don coldsmith,Return of the Spanish (Spanish Bit Saga of the Plains Indians),1993,24,5,2,1993,0
don coldsmith,Thunderstick (Spanish Bit Saga of the Plains Indians),1994,25,5,2,1993,1
don coldsmith,Child of the Dead (Spanish Bit Saga of the Plains Indians),1995,26,2.5,4,1994,1
don coldsmith,Runestone,1995,27,3.3333333333333335,3,1995,0
don coldsmith,Track of the Bear (Spanish Bit Saga of the Plains Indians),1995,28,10,1,1995,0
don coldsmith,Bearer of the Pipe (Spanish Bit Saga of the Plains Indians),1996,29,10,1,1995,1
don coldsmith,Medicine Hat,1998,30,2.5,4,1996,2
don coldsmith,Tallgrass,1998,31,5,2,1998,0
don coldsmith,South Wind,1999,32,0,1,1998,1
don coldsmith,The Lost Band: A Novel (Spanish Bit Series),2000,33,10,1,1999,1
don coldsmith,The Lost Band,2001,34,5.5,2,2000,1
don coldsmith,The Elk-Dog Heritage : #1-Spanish Bit Series (Spanish Bit),2003,35,0,1,2001,2
don coldsmith,Daughter of the Eagle : #4-Spanish Bit Series (Spanish Bit),2004,36,0,1,2003,1
don george,The Kindness of Strangers (Armchair Reading),2003,2,2.4444444444444446,9,2000,3
don h. debrandt,Steeldriver,1998,2,0,2,1992,6
don hutchison,Northern Frights 3,1995,2,0,1,1992,3
don hutchison,"Northern Frights 4 (The Northern Frights , Vol 4)",1997,3,0,1,1995,2
don hutchison,The Scarlet Riders: Action-Packed Mountie Stories from the Fabulous Pulps,1998,4,0,1,1997,1
don hutchison,Northern Frights 5 (Northern Frights),1999,5,0,1,1998,1
don imus,GOD'S OTHER SON,1994,2,2.111111111111111,9,1987,7
don imus,"Two Guys Four Corners: Great Photographs, Great Times, and a Million Laughs",1997,3,5,2,1994,3
don pendelton,"Assault Reflex  (The Executioner #243) (Don Pendleton's the Executioner, No 243)",1999,2,0,1,1990,9
don pendelton,The Executioner: Nuclear Game,2003,3,0,1,1999,4
don pendelton,"Deadly Pursuit : The Moon Shadow Trilogy (Executioner, 297)",2003,4,0,1,2003,0
don w. weber,Silent Witness: The Karla Brown Murder Case,1993,2,1.7142857142857142,14,1991,2
don w. weber,Secret Lessons,1994,3,0,1,1993,1
don weekes,The Original Six: Old-Time Hockey Trivia,1995,2,6,1,1994,1
don weekes,Classic Hockey Trivia: Quizzes * Games * Puzzles,1997,3,0,1,1995,2
don weekes,Puck Stoppin' Trivia: Great Goalies Galore!,1999,4,8,1,1997,2
donald a. davis,Death of an Angel,1994,2,2.5,6,1991,3
donald a. davis,Death Cruise,1996,3,6.666666666666667,6,1994,2
donald a. davis,Hush Little Babies : The True Story Of A Mother Who Murdered Her Own Children (St. Martin's True Crime Library),1997,4,3.3333333333333335,6,1996,1
donald a. davis,The Last Man on the Moon : Astronaut Eugene Cernan and America's Race in Space,1999,5,5,2,1997,2
donald bain,"Gin and Daggers: A Murder, She Wrote Mystery Novel (Murder She Wrote (Paperback))",2000,2,1.6,5,1990,10
donald bain,Murder She Wrote : Provence to Die for,2002,3,3.625,8,2000,2
donald bain,"Murder, She Wrote: A Vote for Murder (Murder She Wrote (Paperback))",2004,4,0,1,2002,2
donald d. davis,Thirteen Miles from Suncrest,1996,2,0,1,1993,3
donald d. davis,See Rock City: A Story Journey Through Appalachia (American Storytelling (Paperback)),1996,3,0,1,1996,0
donald hall,Ox Cart Man,1979,2,0,1,1968,11
donald hall,Ox-Cart Man,1983,3,4.75,4,1979,4
donald hall,Fathers Playing Catch With Sons,1986,4,3.5,2,1983,3
donald hall,Ideal Bakery,1988,5,0,1,1986,2
donald hall,Seasons at Eagle Pond,1991,6,0,1,1988,3
donald hall,"String Too Short to Be Saved (Nonpareil Books, No. 5)",1992,7,0,2,1991,1
donald hall,Their Ancient Glittering Eyes: Remembering Poets and More Poets,1992,8,8,1,1992,0
donald hall,The Contemporary Essay,1995,9,9,1,1992,3
donald hall,Principal Products of Portugal: Prose Pieces,1995,10,9,1,1995,0
donald hall,"Writing Well, 5e",1998,11,0,1,1995,3
donald hall,Fathers Playing Catch With Sons: Essays on Sport (Mostly Baseball),1998,12,5,1,1998,0
donald hall,Without: Poems,1998,13,0,1,1998,0
donald moffitt,Genesis Quest,1986,2,0,2,1979,7
donald moffitt,The Genesis Quest,2003,3,8,1,1986,17
donald moffitt,Second Genesis,2003,4,4,2,2003,0
donald o. clifton,Soar with Your Strengths,1995,2,0,1,1992,3
donald palmer,Looking at Philosophy: The Unbearable Heaviness of Philosophy Made Lighter,1994,2,0,1,1988,6
donald palmer,"Sartre for Beginners (Writers and Readers Documentary Comic Book,)",1995,3,4,2,1994,1
donald richie,Introducing Japan,1994,2,0,1,1993,1
donald richie,The Donald Richie Reader: 50 Years of Writing on Japan,2001,3,6,1,1994,7
donald rumbelow,The complete Jack the Ripper,1987,2,0,1,1975,12
donald rumbelow,Jack the Ripper: The Complete Casebook,1988,3,2.5,2,1987,1
donald sassoon,Becoming Mona Lisa,2003,2,7,1,2001,2
donald westlake,Le Couperet,2000,2,6,1,1987,13
donatien alphonse franã?â§ois de sade,Journal inÃ?Â©dit,1994,2,0,1,1977,17
donna ball,Just Before Dawn,1997,2,0,1,1991,6
donna ball,Dark Angel,1998,3,0,3,1997,1
donna boundy,Hocus-Pocus Magical Cookbooks,2001,2,9.5,2,1993,8
donna erickson,Donna's Day : Fun Activities That Bring the Family Together,1998,2,0,1,1989,9
donna erickson,"Donna Erickson's Fabulous Funstuff for Families: 100s of the best award-winning activities, games, and crafts from Donna's Prime Time books and TV show",2001,3,0,1,1998,3
donna grant,Better Than I Know Myself,2004,2,9,2,2002,2
donna huxley,"Number One (Harlequin Presents, No 776)",1985,2,0,2,1984,1
donna huxley,Stranger To Love,1985,3,0,1,1985,0
donna leon,Death in a Strange Country,1993,2,6,1,1992,1
donna leon,Death in a Strange Country,1995,3,2,4,1993,2
donna leon,Dressed for Death: A Guido Brunetti Mystery,1995,4,0,3,1995,0
donna leon,Death At La Fenice,1995,5,3.5714285714285716,7,1995,0
donna leon,Venezianisches Finale. Commissario Brunettis erster Fall.,1995,6,3.682926829268293,41,1995,0
donna leon,The Anonymous Venetian (Ulverscroft Large Print Series),1996,7,0,1,1995,1
donna leon,Endstation Venedig. Commissario Brunettis zweiter Fall.,1996,8,4.083333333333333,24,1996,0
donna leon,Vendetta. Commissario Brunettis vierter Fall.,1997,9,10,1,1996,1
donna leon,Venezianische Scharade. Commissario Brunettis dritter Fall.,1997,10,4.7894736842105265,19,1997,0
donna leon,The Death of Faith,1997,11,0,4,1997,0
donna leon,Death in a Strange Country,1997,12,0,1,1997,0
donna leon,Vendetta. Commissario Brunettis vierter Fall.,1998,13,4.818181818181818,11,1997,1
donna leon,Acqua Alta,1998,14,7,1,1998,0
donna leon,Acqua alta. Commissario Brunettis fÃ?Â¼nfter Fall.,1999,15,3.4705882352941178,17,1998,1
donna leon,NobiltÃ?Â . Commissario Brunettis siebter Fall.,2000,16,8,2,1999,1
donna leon,In Sachen Signora Brunetti. Der achte Fall.,2000,17,7.8,5,2000,0
donna leon,Endstation Venedig. Commissario Brunettis zweiter Fall.,2000,18,0,1,2000,0
donna leon,Sanft entschlafen. Commissario Brunettis sechster Fall.,2000,19,5.555555555555555,9,2000,0
donna leon,Nobilta. Commissario Brunettis siebter Fall.,2001,20,3.8333333333333335,18,2000,1
donna leon,Feine Freunde. Commissario Brunettis neunter Fall.,2001,21,3.25,4,2001,0
donna leon,Friends in High Places,2001,22,2,21,2001,0
donna leon,PÃ?Â©chÃ?Â©s mortels,2001,23,0,1,2001,0
donna leon,In Sachen Signora Brunetti. Der achte Fall.,2001,24,6.111111111111111,9,2001,0
donna leon,Feine Freunde. Commissario Brunettis neunter Fall.,2002,25,4.166666666666667,12,2001,1
donna leon,Das Gesetz der Lagune. Commissario Brunettis zehnter Fall.,2002,26,7.333333333333333,3,2002,0
donna leon,Uniform Justice: A Commissario Guido Brunetti Mystery,2003,27,5,8,2002,1
donna leon,Die dunkle Stunde der Serenissima. Commissario Brunettis elfter Fall.,2003,28,2.6666666666666665,3,2003,0
donna leon,Malas Artes,2003,29,6,1,2003,0
donna leon,A Noble Radiance,2003,30,2.6956521739130435,23,2003,0
donna leon,Muerte En LA Fenice,2003,31,4,2,2003,0
donna leon,Acqua Alta,2003,32,0,2,2003,0
donna leon,Wilful Behaviour,2003,33,7,2,2003,0
donna leon,Death at La Fenice : A Commissario Guido Brunetti Mystery,2004,34,9,1,2003,1
donna leon,Doctored Evidence: A Commissario Guido Brunetti Mystery (Commissario Guido Brunetti Mysteries),2004,35,6,4,2004,0
donna leon,Uniform Justice (Penguin Mysteries (Paperback)),2004,36,6.333333333333333,6,2004,0
donna m. jackson,The Bone Detectives : How Forensic Anthropologists Solve Crimes and Uncover Mysteries of the Dead,2001,2,0,2,1996,5
donna m. jackson,Twin Tales : The Magic and Mystery of Multiple Birth,2001,3,7,1,2001,0
donna m. jackson,Hero Dogs : Courageous Canines in Action,2003,4,10,1,2001,2
donna morrissey,Kit's Law,2001,2,9,1,1999,2
donna morrissey,Kit's Law : A Novel,2001,3,2.5833333333333335,12,2001,0
donna morrissey,Downhill Chance,2002,4,1.4,5,2001,1
donna morrissey,Downhill Chance,2003,5,1.5,4,2002,1
donna smallin,7 Simple Steps to Unclutter Your Life,2000,2,0,2,1999,1
donna smallin,Organizing Plain and Simple: A Ready Reference Guide With Hundreds Of Solutions to Your Everyday Clutter Challenges,2002,3,0,1,2000,2
donna tartt,Secret History,1993,2,2.9940119760479043,167,1992,1
donna tartt,Die geheime Geschichte.,1995,3,4.625,16,1993,2
donna tartt,Secret History : A Novel,1996,4,4.732558139534884,86,1995,1
donna tartt,The Little Friend,2002,5,2.2873563218390807,87,1996,6
donna tartt,The Secret History,2002,6,8,2,2002,0
donna tartt,The Little Friend,2003,7,1.4807692307692308,52,2002,1
doranna durgin,TOUCHED BY MAGIC,1996,2,0,3,1994,2
doranna durgin,Barrenlands,1998,3,7,1,1996,2
doranna durgin,"Tooth and Claw (Star Trek The Next Generation, No 60)",2001,4,0.8,5,1998,3
doranna durgin,Gene Roddenberry's Earth: Final Conflict : Heritage (Gene Roddenberry's Earth--Final Conflict),2001,5,8,1,2001,0
doranna durgin,Impressions (Angel),2003,6,0,2,2001,2
doranna durgin,Femme Fatale (Feature Anthology),2003,7,0,3,2003,0
doriel hall,Healing With Meditation,1997,2,0,1,1996,1
doriel hall,Discover Meditation (Discover),1997,3,4,2,1997,0
doris buchanan smith,A Taste of Blackberries,1982,2,0,1,1975,7
doris buchanan smith,Return to Bitter Creek: A Novel,1988,3,8,1,1982,6
doris buchanan smith,Voyages,1989,4,0,1,1988,1
doris buchanan smith,A Taste of Blackberries,1992,5,0,1,1989,3
doris buchanan smith,Remember the Red-Shouldered Hawk,1994,6,0,1,1992,2
doris buchanan smith,Best Girl,1995,7,0,1,1994,1
doris dewitz,StudentInnenkÃ?Â¼che vegetarisch.,1999,2,0,1,1996,3
doris grumbach,The Magician's Girl,1993,2,8,1,1985,8
doris grumbach,Coming into the End Zone: A Memoir,1993,3,9,1,1993,0
doris grumbach,The Ladies,1993,4,4,2,1993,0
doris grumbach,Chamber Music,1993,5,3,2,1993,0
doris grumbach,Fifty Days of Solitude,1994,6,1.7142857142857142,7,1993,1
doris grumbach,Life in a Day,1996,7,0,1,1994,2
doris tomaselli,My Little People School Bus: A Lift-The-Flap Playbook (Fisher-Price Lift-the-Flap Playbooks),1997,2,0,1,1997,0
dorothy b. hughes,The Fallen Sparrow,1988,2,0,1,1984,4
dorothy bryant,Day in San Francisco,1983,2,0,1,1976,7
dorothy bryant,The Kin of Ata Are Waiting for You,1997,3,3,6,1983,14
dorothy bryant,The Test,2001,4,6,1,1997,4
dorothy dunnett,King Hereafter: A Novel,1982,2,0,2,1971,11
dorothy dunnett,The Ringed Castle,1984,3,0,1,1982,2
dorothy dunnett,Game of Kings,1984,4,0,1,1984,0
dorothy dunnett,"Niccolo Rising (The House of Niccolo, 1)",1988,5,3,2,1984,4
dorothy dunnett,"The Unicorn Hunt (Dunnett, Dorothy. House of Niccolo.)",1994,6,0,2,1988,6
dorothy dunnett,"To Lie With Lions (The House of Niccolo, 6)",1996,7,0,1,1994,2
dorothy dunnett,"The Disorderly Knights (Lymond Chronicles, 3)",1997,8,6.333333333333333,3,1996,1
dorothy dunnett,"The Game of Kings (Lymond Chronicles, 1)",1997,9,2.6315789473684212,19,1997,0
dorothy dunnett,Checkmate : Sixth in the Legendary Lymond Chronicles (Lymond Chronicles),1997,10,5,4,1997,0
dorothy dunnett,The Ringed Castle (Lymond Chronicles),1997,11,6.333333333333333,3,1997,0
dorothy dunnett,Queens' Play (Legendary Lymond Chronicles),1997,12,3.2857142857142856,7,1997,0
dorothy dunnett,Pawn in Frankincense : Fourth in the Legendary Lymond Chronicles (Lymond Chronicles/Dorothy Dunnett),1997,13,6.333333333333333,3,1997,0
dorothy dunnett,King Hereafter,1998,14,2.7142857142857144,7,1997,1
dorothy dunnett,Caprice and Rondo (House of Niccolo/Dorothy Dunnett),1998,15,0,1,1998,0
dorothy dunnett,"Caprice and Rondo (The House of Niccolo, 7)",1999,16,10,1,1998,1
dorothy dunnett,"To Lie with Lions : The Sixth Book of The House of Niccolo (Dunnett, Dorothy. House of Niccolo, 6th.)",1999,17,8,3,1999,0
dorothy dunnett,Scales of Gold : The Fourth Book of The House of Niccolo (House of Niccolo/Dorothy Dunnett),1999,18,5,2,1999,0
dorothy dunnett,"Niccolo Rising (The House of Niccolo, 1)",1999,19,3.8333333333333335,6,1999,0
dorothy dunnett,The Spring of the Ram : The Second Book of The House of Niccolo (House of Niccolo/Dorothy Dunnett),1999,20,10,1,1999,0
dorothy dunnett,Race of Scorpions (House of Niccolo),1999,21,5,2,1999,0
dorothy dunnett,"The Unicorn Hunt : The Fifth Book of the House of Niccolo (Dunnett, Dorothy. House of Niccolo, 5th.)",1999,22,10,1,1999,0
dorothy dunnett,"Gemini (The House of Niccolo, 8)",2000,23,0,1,1999,1
dorothy dunnett,"Gemini (The House of Niccolo, 8)",2001,24,0,1,2000,1
dorothy l. sayers,The documents in the case,1968,2,7,1,1957,11
dorothy l. sayers,The Five Red Herrings,1976,3,4.5,2,1968,8
dorothy l. sayers,Human and Inhuman Stories,1977,4,0,1,1976,1
dorothy l. sayers,Unnatural Death,1978,5,8,2,1977,1
dorothy l. sayers,The Unpleasantness at the Bellona Club,1978,6,0,2,1978,0
dorothy l. sayers,FÃ?Â¼nf falsche FÃ?Â¤hrten. ( The Five Red Herrings),1980,7,4.75,4,1978,2
dorothy l. sayers,Four Complete Lord Peter Wimsey Novels,1982,8,0,4,1980,2
dorothy l. sayers,Aufruhr in Oxford. Gaudy Night,1983,9,8,1,1982,1
dorothy l. sayers,Strong Poison,1985,10,5,7,1983,2
dorothy l. sayers,Murder Must Advertise,1985,11,2.4285714285714284,7,1985,0
dorothy l. sayers,Five Red Herrings,1986,12,2.3333333333333335,3,1985,1
dorothy l. sayers,Gaudy Night,1986,13,1,7,1986,0
dorothy l. sayers,Have His Carcase,1986,14,2.5714285714285716,7,1986,0
dorothy l. sayers,Murder Must Advertise,1986,15,6.75,4,1986,0
dorothy l. sayers,Busman's Honeymoon: A Love Story with Detective Interruptions,1986,16,1.3333333333333333,6,1986,0
dorothy l. sayers,Unnatural Death,1987,17,2.6666666666666665,3,1986,1
dorothy l. sayers,Clouds of Witness,1987,18,0,1,1987,0
dorothy l. sayers,Strong Poison,1987,19,0,1,1987,0
dorothy l. sayers,Have His Carcase,1987,20,0,1,1987,0
dorothy l. sayers,Strong Poison,1987,21,0,3,1987,0
dorothy l. sayers,Hangman's Holiday: A Collection of Short Mysteries,1987,22,7.5,2,1987,0
dorothy l. sayers,Die letzte Fahrt des Admirals. 13 Autoren schreiben einen Kriminalroman.,1987,23,2,3,1987,0
dorothy l. sayers,The dragon's head: Classic English short stories (Classic English short stories),1988,24,2,2,1987,1
dorothy l. sayers,The Nine Tailors (Hbj Modern Classics),1989,25,0,1,1988,1
dorothy l. sayers,Have His Carcase (A Lord Peter Wimsey Mystery With Harriet Vane),1993,26,0,1,1989,4
dorothy l. sayers,Hangman's Holiday: A Collection of Short Mysteries,1993,27,0,1,1993,0
dorothy l. sayers,In the Teeth of the Evidence: A Lord Peter Wimsey Mystery Collection,1993,28,7,1,1993,0
dorothy l. sayers,Strong Poison (A Lord Peter Wimsey Msytery),1993,29,6,1,1993,0
dorothy l. sayers,Murder Must Advertise (Lord Peter Wimsey Mysteries (Paperback)),1993,30,10,1,1993,0
dorothy l. sayers,Busman's Honeymoon,1995,31,5.333333333333333,6,1993,2
dorothy l. sayers,Gaudy Night,1995,32,2.3125,16,1995,0
dorothy l. sayers,Strong Poison,1995,33,5.5,8,1995,0
dorothy l. sayers,The Unpleasantness at the Bellona Club,1995,34,5,3,1995,0
dorothy l. sayers,In the Teeth of the Evidence : In the Teeth of the Evidence (Lord Peter Wimsey Mysteries (Paperback)),1995,35,1.4,5,1995,0
dorothy l. sayers,Lord Peter Views the Body : Lord Peter Views the Body (Lord Peter Wimsey Mysteries (Paperback)),1995,36,7,1,1995,0
dorothy l. sayers,The Five Red Herrings,1995,37,1.1666666666666667,6,1995,0
dorothy l. sayers,Unnatural Death (Lord Peter Wimsey Mysteries (Paperback)),1995,38,2,7,1995,0
dorothy l. sayers,Hangman's Holiday : Hangman's Holiday,1995,39,3.5,2,1995,0
dorothy l. sayers,Have His Carcase,1995,40,2.3333333333333335,3,1995,0
dorothy l. sayers,The Documents in the Case,1995,41,8,1,1995,0
dorothy l. sayers,Murder Must Advertise,1995,42,2.4,10,1995,0
dorothy l. sayers,Whose Body? (Lord Peter Wimsey Mysteries (Paperback)),1995,43,2.5555555555555554,9,1995,0
dorothy l. sayers,Clouds of Witness,1995,44,3.7142857142857144,7,1995,0
dorothy l. sayers,Lord Peter (Lord Peter Wimsey Mysteries (Paperback)),1995,45,0,1,1995,0
dorothy l. sayers,The Letters of Dorothy L. Sayers: 1899-1936 : The Making of a Detective Novelist,1996,46,0,1,1995,1
dorothy l. sayers,"Thrones, Dominations",1998,47,3.3333333333333335,3,1996,2
dorothy l. sayers,"Thrones, Dominations",1999,48,3.8666666666666667,15,1998,1
dorothy l. sayers,Strong Poison (Audio Editions Mystery Masters),2000,49,0,1,1999,1
dorothy l. sayers,Aufruhr in Oxford.,2000,50,0,3,2000,0
dorothy l. sayers,The Nine Tailors,2001,51,0,2,2000,1
dorothy l. sayers,Lord Peter : The Complete Lord Peter Wimsey Stories,2001,52,5,2,2001,0
dorothy l. sayers,Sayers on Holmes,2001,53,0,1,2001,0
dorothy l. sayers,Busman's Honeymoon: A Lord Peter Wimsey and Harriet Vane Mystery (Mystery Masters Series),2003,54,2.3333333333333335,3,2001,2
dorothy leeds,Marketing Yourself: The Ultimate Job Seeker's Guide,1992,2,0,1,1987,5
dorothy leeds,Smart Questions,1995,3,0,2,1992,3
dorothy leeds,The 7 Powers of Questions: Secrets to Successful Communication in Life and at Work,2000,4,0,7,1995,5
dorothy leeds,Smart Questions: The Essential Strategy for Successful Managers,2000,5,0,1,2000,0
dorothy lehmkuhl,Organizing for the Creative Person,1998,2,8,1,1994,4
dorothy leigh sayers,Have His Carcase,1968,2,6.333333333333333,3,1966,2
dorothy leigh sayers,Busman's Honeymoon,1983,3,0,1,1968,15
dorothy leigh sayers,Gaudy Night,1983,4,4.333333333333333,6,1983,0
dorothy leigh sayers,Documents in the Case,1987,5,9,2,1983,4
dorothy leigh sayers,Murder Most Cozy,1993,6,1.6,5,1987,6
dorothy leigh sayers,Whose Body?: A Lord Peter Wimsey Novel,1993,7,0,2,1993,0
dorothy rich,Megaskills: Building Children's Achievement for the Information Age,1998,2,0,1,1992,6
dorothy west,"The Richer, the Poorer: Stories, Sketches, and Reminiscences",1995,2,0,1,1995,0
dorothy west,The Wedding,1996,3,1.5,14,1995,1
dorothy west,The Living Is Easy,1996,4,3.5,2,1996,0
dorothy west,The WEDDING THE,1998,5,0,1,1996,2
doug  lowe,Microsoft Office 2000 for Windows for Dummies Quick Reference,1999,2,5,1,1999,0
doug  lowe,PowerPoint 2002 for Dummies,2001,3,0,1,1999,2
doug  lowe,"Networking for Dummies, Sixth Edition",2002,4,0,1,2001,1
doug lansky,Up the Amazon Without a Paddle,1999,2,3.6,5,1998,1
doug lansky,Last Trout in Venice: The Far-Flung Escapades of an Accidental Adventurer,2001,3,6.5,2,1999,2
doug lansky,First- Time Around the World (Rough Guides),2003,4,0,1,2001,2
doug radcliffe,Age of Mythology: Sybex Official Strategies &amp; Secrets,2002,2,0,1,2001,1
doug wilson,Labour of Love: A Novel,1994,2,0,1,1993,1
douglas brinkley,The Unfinished Presidency: Jimmy Carter's Journey Beyond the White House,1998,2,5,1,1993,5
douglas brinkley,Rosa Parks (Penguin Lives),2000,3,2.5,2,1998,2
douglas brinkley,"Wheels for the World: Henry Ford, His Company, and a Century of Progress, 1903-2003",2003,4,0,1,2000,3
douglas c. waller,Air Warriors: The Inside Story of the Making of a Navy Pilot,1999,2,2.5,2,1995,4
douglas c. waller,Big Red: Three Months on Board a Trident Nuclear Submarine,2001,3,4,2,1999,2
douglas c. waller,Big Red: The Three-Month Voyage of a Trident Nuclear Submarine,2002,4,3.5,2,2001,1
douglas clegg,BREEDER,1990,2,1,6,1989,1
douglas clegg,NEVERLAND,1991,3,0,7,1990,1
douglas clegg,The Children's Hour,1995,4,0,2,1991,4
douglas clegg,The Halloween Man,1998,5,1,11,1995,3
douglas clegg,The Nightmare Chronicles,1999,6,1.8333333333333333,6,1998,1
douglas clegg,You Come When I Call You,2000,7,0.5555555555555556,9,1999,1
douglas clegg,Mischief,2000,8,1.1538461538461537,13,2000,0
douglas clegg,Naomi,2001,9,2.2142857142857144,14,2000,1
douglas clegg,The Hour Before Dark,2003,10,4.5,8,2001,2
douglas clegg,Nightmare House,2004,11,1.75,4,2003,1
douglas hirt,McKendree,1997,2,0,1,1994,3
douglas hirt,Brandish,1997,3,0,1,1997,0
douglas hirt,Shadow Road,1999,4,0,1,1997,2
douglas hirt,The Wrong Man,2000,5,0,2,1999,1
douglas hirt,A Good Town,2001,6,0,2,2000,1
douglas niles,"Darkwell (Forgotten Realms, Moonshae Trilogy, Book 3)",1989,2,1.25,4,1987,2
douglas niles,"Ironhelm: The Maztica Trilogy, Book 1 (Forgotten Realms Fantasy Adventure)",1990,3,0,5,1989,1
douglas niles,"Viperhand: Forgotten Realms (Maztica Trilogy, Book 2)",1990,4,0,5,1990,0
douglas niles,"The Kinslayer Wars (Dragonlance Elven Nations, vol.2)",1991,5,2.7777777777777777,9,1990,1
douglas niles,"Feathered Dragon (The Mazica Trilogy, Book Three)",1991,6,0,3,1991,0
douglas niles,Coral Kingdom (Forgotten Realms Fantasy Adventure),1992,7,4.666666666666667,3,1991,1
douglas niles,"Prophet of Moonshae (The Druidhome Trilogy, Book 1)",1992,8,2.3333333333333335,6,1992,0
douglas niles,Black Wizards (Forgotten Realms : Book 2 in the Moonshae Trilogy),1992,9,0.8333333333333334,6,1992,0
douglas niles,"The Complete Book of Gnomes &amp; Halflings (Advanced Dungeons &amp; Dragons, 2nd Edition, Phbr9. Player's Handbook Rules Supplement)",1993,10,0,1,1992,1
douglas niles,"Emperor of Ansalon (Dragonlance Saga, Villains, Vol 3)",1993,11,5,2,1993,0
douglas niles,"The Druid Queen (Forgotten Realms, the Druidhome Trilogy, Book 3)",1993,12,4.5,2,1993,0
douglas niles,"A Breach in the Watershed (Watershed Trilogy, Book 1)",1995,13,2.1666666666666665,6,1993,2
douglas niles,Pawns Prevail (1st Quest),1995,14,0,1,1995,0
douglas niles,"The Kagonesti (Dragonlance Lost Histories, Vol. 1)",1995,15,4.25,4,1995,0
douglas niles,"The Dragons (Dragonlance Lost Histories, Vol. 6)",1996,16,2.5,4,1995,1
douglas niles,"A Breach in the Watershed (Watershed Trilogy, Book 1)",1996,17,2.3,10,1996,0
douglas niles,The Rod of Seven Parts (Ad&amp;D Hardcover Novels),1996,18,0,2,1996,0
douglas niles,"Fistandantilus Reborn (Dragonlance Lost Legends, Vol. 2)",1997,19,0,3,1996,1
douglas niles,Darkenheight (Watershed Trilogy),1997,20,3,5,1997,0
douglas niles,"The Last Thane (Dragonlance Chaos Wars, Vol. 1)",1998,21,0,3,1997,1
douglas niles,"War of Three Waters (Watershed Trilogy , No 3)",1998,22,5.333333333333333,3,1998,0
douglas niles,"The Puppet King (Dragonlance Chaos Wars, Vol. 3)",1999,23,1.3333333333333333,6,1998,1
douglas niles,"Gilthas, Orador de Los Soles",2000,24,7,1,1999,1
douglas niles,"Circle at Center (Seven Circles Trilogy, Book 1)",2000,25,5.666666666666667,3,2000,0
douglas niles,"World Fall (Seven Circles Trilogy, Book 2)",2001,26,9.5,2,2000,1
douglas niles,"The Messenger (Dragonlance Icewall, Vol. 1)",2001,27,0,4,2001,0
douglas niles,Fox on the Rhine (Fox on the Rhine),2002,28,7,1,2001,1
douglas niles,"Circle at Center (Seven Circles Trilogy, Book 1)",2002,29,2.3333333333333335,3,2002,0
douglas niles,"The Goddess Worldweaver (Seven Circles Trilogy, Book 3)",2003,30,9,1,2002,1
douglas niles,"Winterheim (Dragonlance: Icewall Trilogy, Vol. 3)",2003,31,7,1,2003,0
douglas niles,The Goddess Worldweaver (Seven Circles Trilogy (Paperback)),2004,32,6,1,2003,1
douglas sadownick,Sex Between Men: An Intimate History of the Sex Lives of Gay Men Postwar to Present,1996,2,6,1,1994,2
douglas w. clark,Whirlwind Alchemy,1993,2,0,2,1990,3
dr. james dobson,Love For a Lifetime,1987,2,0,1,1974,13
dr. james dobson,Love For A Lifetime : Building A Marriage That Will Go The Distance,1988,3,0,1,1987,1
dr. james dobson,Preparing for Adolescence: Caution Changes Ahead,1989,4,0,2,1988,1
dr. james dobson,Love For A Lifetime (mini) : Building A Marriage That Will Go The Distance (A Daily Reminder),1994,5,3.2,5,1989,5
dr. james dobson,Love For a Lifetime,1994,6,0,1,1994,0
dr. james dobson,Night Light : A Devotional for Couples,2000,7,4,3,1994,6
dr. james dobson,Night Light for Parents : A Devotional,2002,8,9,1,2000,2
dr. james dobson,Marriage Under Fire : Why We Must Win This Battle,2004,9,0,1,2002,2
dr. joe aldrich,Lifestyle Evangelism : Learning To Open Your Life To Those Around You,1988,2,7,2,1983,5
dr. joe aldrich,Lifestyle Evangelism : Learning to Open Your Life to Those Around You,1999,3,0,2,1988,11
duane t. gish,Dinosaurs by Design,1992,2,0,1,1979,13
duane t. gish,The Amazing Story of Creation: From Science and the Bible,1996,3,5,1,1992,4
duane unkefer,Gray Eagles,1987,2,2.5,2,1985,2
dudley pope,The Black Ship (Heart of Oak Sea Classics Series),1998,2,0,1,1989,9
dudley pope,Ramage: The Lord Ramage Novels No. 1,2000,3,4,1,1998,2
dudley pope,Ramage &amp; the Freebooters: The Lord Ramage Novels No. 3,2000,4,0,3,2000,0
dudley pope,"Ramage &amp; the Rebels (Lord Ramage Novels, No. 9)",2001,5,0,1,2000,1
dudley pope,"Ramage's Signal (Lord Ramage Novels, No. 11)",2001,6,0,1,2001,0
dudley pope,"The Ramage Touch (Lord Ramage Novels, No. 10)",2001,7,0,1,2001,0
dudley pope,Ramage and the Drum Beat,2002,8,0,1,2001,1
dudley pope,Ramage,2002,9,5,1,2002,0
dudley pope,Ramage and the Dido,2002,10,5,1,2002,0
dudley pope,Ramage,2002,11,0,1,2002,0
duncan j. watts,Six Degrees: The Science of a Connected Age,2004,2,9,2,1999,5
dutch sheets,The River of God,1998,2,0,1,1997,1
dutch sheets,God's Timing for Your Life (Life Point),2001,3,9,1,1998,3
dutch sheets,Tell Your Heart to Beat Again: Discover the Good in What You're Going Through,2002,4,4.5,2,2001,1
e. barrie kavasch,"American Indian Healing Arts : Herbs, Rituals, and Remedies for Every Season of Life (Healing Arts)",1999,2,5,3,1979,20
e. bradford burns,Latin America: A Concise Interpretive History (7th Edition),2001,2,0,1,1993,8
e. c. parnwell,The New Oxford Picture Dictionary: English/Spanish,1989,2,9,1,1982,7
e. e cummings,"Complete poems, 1913-1962 (A Harvest/HBJ book)",1980,2,0,1,1972,8
e. e. knight,"The Way of the Wolf (The Vampire Earth, Book 1)",2003,2,2.4285714285714284,7,2001,2
e. e. knight,"Choice of the Cat (The Vampire Earth, Book 2)",2004,3,5,2,2003,1
e. f. bleiler,Marmaduke Multiply's: Merry Method of Making Minor Mathematicians,1971,2,1.3333333333333333,3,1963,8
e. f. bleiler,"Three Gothic Novels: The Castle of Otranto, Vathek, The Vampyre",1978,3,0,2,1971,7
e. l. larkin,Dead Men Die (Worldwide Library Mysteries),2001,2,3,2,2001,0
e. l. larkin,Hear My Cry (Worldwide Library Mysteries),2001,3,3.5,2,2001,0
e. l. larkin,Hear Me Die (Worldwide Library Mysteries),2001,4,1,7,2001,0
e. p. sanders,The Historical Figure of Jesus,1994,2,0,1,1991,3
e. p. sanders,The Historical Figure of Jesus,1996,3,2.5,2,1994,2
e. t. a. hoffmann,The Tales of Hoffmann (Penguin Classics),1990,2,0,2,1979,11
e. t. a. hoffmann,The Nutcracker and the Golden Pot (Dover Thrift Editions),1993,3,0,6,1990,3
e. t. a. hoffmann,The Story of the Nutcracker (Children's Thrift Classics),1996,4,0,1,1993,3
e. t. a. hoffmann,The Life and Opinions of the Tomcat Murr: Together With a Fragmentary Biography of Kapellmeister Johannes Kreisler on Random Sheets of Waste Paper (Penguin Classics),1999,5,0,2,1996,3
e. t. a. hoffmann,Mademoiselle De Scuderi,2003,6,1.5,4,1999,4
e. t. randall,Town in Terror (Alien Adventures),1985,2,10,1,1985,0
e. v. hill,"Victory in Jesus, Running the Race You are Meant to Win",2003,2,0,1,2002,1
e.e. \doc smith,First Lensman,1982,2,0,2,1982,0
e.e. \doc smith,Galatic Patrol,1982,3,6,1,1982,0
e.e. \doc smith,Subspace Encounter,1983,4,0,1,1982,1
e.r. eddison,The Worm Ouroboros,1991,2,0,1,1981,10
e.r. eddison,The Worm Ouroboros,1993,3,0,1,1991,2
e.v. cunningham,The Case of the Russian Diplomat,1981,2,0,1,1981,0
e.v. cunningham,The Case of the Angry Actress,1984,3,0,3,1981,3
e.v. cunningham,The Wabash Factor,1986,4,0,1,1984,2
earl mindell,Earl Mindells New and Revised Vitamin Bible,1985,2,0,2,1982,3
earl mindell,"Earl Mindell's Shaping Up With Vitamins: How the Right Foods and Nutrients Can Help Shape Up Your Body, Your Mind, and Your Sex Life",1986,3,0,1,1985,1
earl mindell,Earl Mindell's Vitamin Bible Revised and Updated,1991,4,2.5,6,1986,5
earl mindell,Earl Mindell's Herb Bible,1992,5,1.4285714285714286,7,1991,1
earl mindell,EARL MINDELL'S FOOD AS MEDICINE : WHAT YOU CAN EAT TO HELP PREVENT EVERYTHING FROM COLDS TO HEART DISEASE TO CANCE,1994,6,3.5,2,1992,2
earl mindell,Dr. Earl Mindell's Garlic: The Miracle Nutrient,1994,7,2.3333333333333335,3,1994,0
earl mindell,Dr. Earl Mindell's What You Should Know About Nutrition for Active Lifestyles (Dr. Earl Mindell's Series),1996,8,2,1,1994,2
earl mindell,Dr. Earl Mindell's What You Should Know About Creating Your Personal Vitamin Plan,1996,9,0,1,1996,0
earl mindell,"Earl Mindell's Supplement Bible : A Comprehensive Guide to Hundreds of NEW Natural Products that Will Help You Live Longer, Look Better, Stay Heathier, Improve Strength and Vitality, and Much More! (Better Health for 2003)",2002,10,0,1,1996,6
earlene fowler,Fool's Puzzle,1995,2,3.2058823529411766,34,1994,1
earlene fowler,Irish Chain,1995,3,4.5,4,1995,0
earlene fowler,Irish Chain (Benni Harper Mysteries (Paperback)),1996,4,3.2962962962962963,27,1995,1
earlene fowler,Goose in the Pond (Goose in the Pond),1997,5,0,1,1996,1
earlene fowler,Kansas Troubles,1997,6,2.227272727272727,22,1997,0
earlene fowler,Dove in the Window (Benni Harper Mysteries (Hardcover)),1998,7,0,2,1997,1
earlene fowler,Goose in the Pond (Benni Harper Mysteries (Paperback)),1998,8,1.7857142857142858,14,1998,0
earlene fowler,Dove in the Window (Benni Harper Mystery),1999,9,2.357142857142857,14,1998,1
earlene fowler,Mariner's Compass (Benni Harper Mystery Series),1999,10,0,2,1999,0
earlene fowler,Mariner's Compass (Benni Harper Mysteries (Paperback)),2000,11,4.083333333333333,12,1999,1
earlene fowler,Seven Sisters (Benni Harper Mysteries (Hardcover)),2000,12,0,2,2000,0
earlene fowler,Arkansas Traveler (Benni Harper Mysteries (Hardcover)),2001,13,8,1,2000,1
earlene fowler,Seven Sisters (Benni Harper Mysteries (Paperback)),2001,14,2,19,2001,0
earlene fowler,Arkansas Traveler (Benni Harper Mystery),2002,15,1.5,16,2001,1
earlene fowler,Der MuseumsmÃ?Â¶rder.,2002,16,0,1,2002,0
earlene fowler,Steps to the Altar,2002,17,1.8,5,2002,0
earlene fowler,Die geheime Botschaft.,2003,18,2.25,4,2002,1
earlene fowler,Steps to the Altar (Benni Harper Mystery),2003,19,1.1428571428571428,7,2003,0
earlene fowler,Sunshine and Shadow (Benni Harper Mystery),2003,20,8.333333333333334,3,2003,0
earlene fowler,"Broken Dishes (Fowler, Earlene)",2004,21,8,1,2003,1
earlene fowler,"Broken Dishes (Fowler, Earlene)",2004,22,5.666666666666667,3,2004,0
earlene fowler,Sunshine and Shadow (Benni Harper Mystery Series),2004,23,0,2,2004,0
echo heron,MERCY,1992,2,10,1,1988,4
echo heron,Mercy,1993,3,1,5,1992,1
echo heron,Condition Critical: The Story of a Nurse Continues,1994,4,5.666666666666667,3,1993,1
echo heron,Condition Critical: The Story of a Nurse Continues,1995,5,0,6,1994,1
echo heron,Panic (Panic),1998,6,2.142857142857143,7,1995,3
echo heron,Pulse (Echo Heron),1998,7,7,1,1998,0
echo heron,Paradox (Echo Heron),1998,8,0,3,1998,0
echo heron,Tending Lives: Nurses on the Medical Front,1998,9,10,1,1998,0
echo heron,Tending Lives: Nurses on the Medical Front,1999,10,5.2,5,1998,1
echo heron,Fatal Diagnosis,2000,11,0,4,1999,1
echo heron,Mercy.,2000,12,7,1,2000,0
ed radlauer,Baseball Mania,1987,2,0,1,1981,6
ed sanders,Investigative poetry,1976,2,9,1,1975,1
ed sanders,Tales of Beatnik Glory/2 Volumes in 1,1990,3,8.5,2,1976,14
ed sanders,The Family: The Manson Group and Its Aftermath,1991,4,2.3333333333333335,3,1990,1
ed walters,Ufo Abductions in Gulf Breeze,1994,2,4,4,1991,3
edgar allen poe,The Complete Poems,1999,2,5,5,1993,6
edgar allen poe,"The Black Cat and Other Stories (Penguin Readers, Level 3)",2000,3,3.3333333333333335,3,1999,1
edgar lee masters,The New Spoon River,1968,2,5,1,1962,6
edgar lee masters,Spoon River Anthology (Dover Thrift Editions),1992,3,0,6,1968,24
edgar lee masters,Spoon River Anthology,1992,4,4.6,5,1992,0
edgar pangborn,Still I Persist in Wondering,1978,2,0,1,1976,2
edgar pangborn,A Mirror for Observers,1983,3,4.5,2,1978,5
edgar pangborn,Davy (Collier Nucleus Fantasy &amp; Science Fiction),1990,4,8,1,1983,7
edgar pierre jacobs,"Blake et Mortimer, tome 4 : Le mystÃ?Â¨re de la grande pyramide 1",1996,2,10,1,1996,0
edgar pierre jacobs,"Blake et Mortimer, tome 6 : La marque jaune",1996,3,10,1,1996,0
edgar pierre jacobs,"Blake et Mortimer, Le Rayon \U""""""""",1996,4,10,1,1996,0
edika,"DÃ?Â©sirs exacerbÃ?Â©s, numÃ?Â©ro 6",1993,2,5,1,1993,0
edika,DÃ?Â©biloff profondikoum,1993,3,2.5,2,1993,0
edika,"Tshaw, numÃ?Â©ro 8",1993,4,5,1,1993,0
edika,"Absurdomanies, numÃ?Â©ro 4",1993,5,2.5,2,1993,0
edika,"Happy-ends, numÃ?Â©ro 7",1993,6,0,1,1993,0
edika,"Homo-sapiens connardus, numÃ?Â©ro 2",1998,7,0,2,1993,5
edika,"Yeah, numÃ?Â©ro 3",1998,8,5,1,1998,0
edika,Knock-out !,1999,9,0,1,1998,1
edith fiore,Encounters: A Psychologist Reveals Case Studies of Abductions by Extraterrestrials,1995,2,0,1,1991,4
edith hahn beer,Ich ging durchs Feuer und brannte nicht. Eine auÃ?Â?ergewÃ?Â¶hnliche Lebens- und Liebesgeschichte.,2002,2,2.25,8,1999,3
edith holden,Country Diary of an Edwardian Lady,1982,2,4,2,1977,5
edith holden,Vom GlÃ?Â¼ck mit der Natur zu leben.,1998,3,0,1,1982,16
edith holden,The Country Diary Of An Edwardian Lady,2001,4,3,3,1998,3
edith konecky,A Place at the Table,1989,2,0,1,1978,11
edith konecky,A Place at the Table,1990,3,0,1,1989,1
edith konecky,Allegra Maud Goldman,2001,4,7.4,5,1990,11
editors of cook's illustrated magazine,American Classics (The Best Recipe Series),2002,2,0,1,2002,0
editors of cook's illustrated magazine,Baking Illustrated: A Best Recipe Classic (The Best Recipe Series),2004,3,9,1,2002,2
edmund burke,Precision Heart Rate Training,1998,2,0,1,1990,8
edmund lenihan,Strange Irish Tales for Children,1992,2,4,2,1987,5
edmund swinglehurst,The Life and Works of Botticelli (Worlds Greatest Artists Series),1997,2,0,1,1996,1
edmund swinglehurst,Charles Rennie Mackintosh,2001,3,0,1,1997,4
edna obrien,Mein Irland.,1999,2,5,1,1980,19
edna obrien,Das rauhe Land.,2003,3,0,1,1999,4
eduardo h. galeano,The Book of Embraces,1991,2,5,2,1974,17
eduardo h. galeano,Patas Arriba. la Escuela Del Mundo Al Reves,1998,3,9,1,1991,7
eduardo h. galeano,Open Veins of Latin America: Five Centuries of the Pillage of a Continent,1998,4,0,1,1998,0
edvard radzinskii,Stalin: The First In-Depth Biography Based on Explosive New Documents from Russia's Secret Archives,1996,2,0,1,1993,3
edvard radzinskii,Rasputin,2000,3,1,3,1996,4
edvard radzinskii,The Rasputin File,2001,4,5,2,2000,1
edward bear,The Cocktail Cart,2001,2,0,1,1999,2
edward candy,Words for Murder Perhaps,1985,2,10,1,1985,0
edward f. murphy,"2,715 One-Line Quotations",1996,2,7,1,1992,4
edward hoch,"Best Detective Stories of the Year, 1977",1977,2,0,2,1976,1
edward hoch,"Best Detective Stories of the Year, 1978",1978,3,0,2,1977,1
edward hoch,"The Year's Best Mystery and Suspense Stories, 1983",1983,4,8,1,1978,5
edward humes,Murderer With a Badge: The Secret Life of a Rogue Cop,1993,2,3,3,1992,1
edward humes,Mississippi Mud : Southern Justice and the Dixie Mafia,1995,3,2.5555555555555554,9,1993,2
edward humes,NO MATTER HOW LOUD I SHOUT : A Year in the Life of Juvenile Court,1997,4,4,2,1995,2
edward humes,"MEAN JUSTICE : A TOWN'S TERROR, A PROSECUTOR'S POWER, A BETRAYAL OF INNOCENCE",1999,5,8.5,2,1997,2
edward humes,BABY ER : The Heroic Doctors and Nurses Who Perform Medicine's Tiniest Miracles,2000,6,0,1,1999,1
edward humes,Mean Justice,2003,7,0,2,2000,3
edward humes,School of Dreams: Making the Grade at a Top American High School,2003,8,1.3333333333333333,6,2003,0
edward l. ferman,The Best Horror Stories from the Magazine of Fantasy and Science Fiction,1988,2,0,1,1975,13
edward l. ferman,The Best Horror Stories from the Magazines of Fantasy and Science Fiction,1989,3,2.6666666666666665,3,1988,1
edward l. ferman,Best Horror Stories from Fantasy and Science Fiction Magazine (Best Horror Stories),1989,4,0,2,1989,0
edward l. ferman,The Best From Fantasy and Science Fiction : The Fiftieth Anniversary Anthology (Best from Fantasy and Science Fiction),1999,5,3,3,1989,10
edward l. ferman,The Best From Fantasy and Science Fiction,2000,6,0,2,1999,1
edward lazarus,Closed Chambers: The First Eyewitness Account of the Epic Struggles Inside the Supreme Court,1998,2,0,1,1991,7
edward llewellyn,Word-Bringer,1986,2,0,1,1985,1
edward m. hays,The Gospel of Gabriel: A Life of Jesus the Christ,1996,2,0,1,1988,8
edward mathis,Natural Prey (Dan Roman Mystery),1987,2,0,1,1985,2
edward mathis,Dark Streaks and Empty Places,1988,3,0,1,1987,1
edward mathis,Natural Prey,1988,4,0,3,1988,0
edward mathis,See No Evil,1990,5,1,2,1988,2
edward mathis,September Song,1991,6,0,1,1990,1
edward s. curtis,"Native Nations Miniseries : Chiefs and Warriors (Curtis, Edward S., North American Indian (1996), V. 1.)",1996,2,10,1,1993,3
edward s. curtis,Hidden Faces (Native Nations Series),1997,3,0,1,1996,1
edward s. herman,"Triumph of the Market: Essays on Economics, Politics, and the Media",1995,2,0,1,1988,7
edward s. herman,Manufacturing Consent: The Political Economy of the Mass Media,2002,3,4,8,1995,7
edward sklepowich,A Mystery of Venice: Farewell to the Flesh,1993,2,0,1,1992,1
edward sklepowich,Black Bridge: A Mystery of Venice,1995,3,0,1,1993,2
edward sklepowich,In Venedig weint man nicht. Roman.,1999,4,0,1,1995,4
edward sklepowich,Die schwarze BrÃ?Â¼cke von Venedig.,2000,5,5,3,1999,1
edward sklepowich,Mord im Palazzo.,2000,6,0,2,2000,0
edward sklepowich,Venedig sehen und sterben.,2002,7,0,1,2000,2
edward sklepowich,Deadly to the Sight: A Mystery of Venice,2002,8,0,1,2002,0
edward sklepowich,The Last Gondola: A Mystery of Venice,2003,9,8,1,2002,1
edwin b. williams,Diccionario espaÃ±ol/inglÃ©s inglÃ©s/espaÃ±ol: Bantam,1982,2,0,1,1968,14
edwin b. williams,The Scribner-Bantam English Dictionary,1991,3,3.3333333333333335,3,1982,9
edwin b. williams,Diccionario espaÃ±ol/inglÃ©s inglÃ©s/espaÃ±ol: Bantam New College,1991,4,2.142857142857143,7,1991,0
edwin wilson,Living Theater: A History,1994,2,0,1,1994,0
egbert osterwald,Tod eines Schweins.,1996,2,4,2,1996,0
eiichiro oda,"Buggy the Clown (One Piece, Volume 2)",2003,2,0,1,2003,0
eiichiro oda,One Piece (One Piece),2004,3,0,1,2003,1
eike christian hirsch,Kopfsalat: Spott-Reportagen fÃ¼r Besserwisser,1988,2,0,1,1976,12
eileen fulton,Soap Opera,2000,2,4,7,1995,5
eileen hehl,No Strings Attached (Sweet Dreams No 95),1985,2,0,1,1985,0
eileen hehl,"Playing Games (Sweet Dreams, No 110)",1986,3,0,1,1985,1
eileen hehl,"Playing the Field (Sweet Dreams, No 133)",1987,4,0,1,1986,1
eileen hehl,"Happily Ever After (Sweet Dreams, No 230)",1995,5,9,1,1987,8
elaine ford,Ivory bright (Contemporary American fiction),1987,2,1.75,4,1980,7
elaine ford,Monkey Bay (Contemporary American Fiction),1990,3,0,1,1987,3
elaine ford,Life Designs: A Novel,1997,4,5.666666666666667,3,1990,7
elaine kane,Promise Me,1996,2,0,1,1994,2
elaine pagels,The Gnostic Gospels,1989,2,2.5,10,1988,1
elaine pagels,"Adam, Eve, and the Serpent",1989,3,4.4,5,1989,0
elaine pagels,The Origin of Satan,1995,4,2.3333333333333335,9,1989,6
elaine pagels,The Origin of Satan,1996,5,4.111111111111111,9,1995,1
elaine pagels,Beyond Belief : The Secret Gospel of Thomas,2003,6,3,3,1996,7
elaine pagels,The Gnostic Gospels: A Startling Account of the Meaning of Jesus and the Origin of Christianity Based on Gnostic Gospels and Other Secret Texts,2004,7,5,1,2003,1
elaine pagels,Beyond Belief : The Secret Gospel of Thomas (Vintage),2004,8,2.5,4,2004,0
elaine raco chase,The Best of Elaine Raco Chase: Designing Woman/Video Vixen,1991,2,0,1,1987,4
elaine raco chase,Partners in Crime: A Mystery Anthology,1994,3,0,1,1991,3
elaine raphael,The Story of the First Thanksgiving (Drawing America),1992,2,7,1,1981,11
elaine raphael,Ancient Rome: Drawing History,1995,3,0,1,1992,3
elane osborn,"Honeymoon With A Handsome (Harlequin Intimate Moments, No 748)",1996,2,0,2,1990,6
elane osborn,"Which Twin? (Silhouette Intimate Moments, No 1067)",2001,3,0.8571428571428571,7,1996,5
elane osborn,A Season to Believe,2002,4,0,3,2001,1
eldonna bouton,Journaling from the Heart,2000,2,9.5,2,1999,1
eldonna bouton,Write Away : A Journal Writing Tool Kit,2000,3,10,1,2000,0
eleanor berman,"Away for the Weekend (R): Southeast -- Revised and Updated Edition : Great Getaways for Every Season in Alabama, Georgia, North Carolina, South Carolina and Tennessee (Away for the Weekend Series)",1997,2,0,1,1990,7
eleanor berman,Grandparenting Today: Making the Most of Your Grandparenting Skills With Grandchildren of All Ages (Reader's Digest),1997,3,0,1,1997,0
eleanor berman,Eyewitness Travel Guide to New York (revised),1998,4,0,1,1997,1
eleanor berman,Recommended Bed &amp; Breakfasts New England,1999,5,6,1,1998,1
eleanor berman,Traveling Solo,1999,6,0,2,1999,0
eleanor berman,"Traveling Solo, 3rd: Advice and Ideas for More Than 250 Great Vacations",2001,7,0,1,1999,2
eleanor berman,Eyewitness Top 10 Travel Guides: New York (Eyewitness Travel Top 10),2002,8,2,2,2001,1
eleanor cooney,Deception: A Novel of Mystery and Madness in Ancient China,1994,2,0,2,1990,4
eleanor cooney,Shangri-LA: The Return to the World of Lost Horizon,1996,3,5.333333333333333,3,1994,2
eleanor cooney,L'impÃ?Â©ratrice des mensonges,1998,4,0,1,1996,2
eleanor cooney,Die eiserne Kaiserin. Ein Richter- Di- Roman.,1998,5,0,2,1998,0
eleanor cooney,Der Fluch der Kaiserin. Ein Richter- Di- Roman.,2001,6,0,2,1998,3
eleanor cooney,Death in Slow Motion : My Mother's Descent into Alzheimer's,2003,7,0,2,2001,2
eleanor freemont,Muppet Babies: Baby Gonzo Has a Cold (Golden Little Look-Look Books),1995,2,4.5,2,1994,1
eleanor lowe clymer,The Trolley Car Family,1987,2,2.5,4,1982,5
eleanor roosevelt,Eleanor and Harry : The Correspondence of Eleanor Roosevelt and Harry S. Truman (Lisa Drew Books (Hardcover)),2002,2,9,1,2000,2
eleanor schick,My Album,1984,2,5,1,1974,10
eleanor woods,Texas Wildfire (Candlelight Supreme),1987,2,0,1,1983,4
elie wiesel,Souls on fire;: Portraits and legends of Hasidic masters,1973,2,8,1,1971,2
elie wiesel,Night,1973,3,4,2,1973,0
elie wiesel,Messengers of God: Biblical portraits and legends,1976,4,10,1,1973,3
elie wiesel,The Testament,1981,5,10,1,1976,5
elie wiesel,Dawn,1982,6,6.5,4,1981,1
elie wiesel,Somewhere a Master: Further Hasidic Portraits and Legends,1982,7,0,1,1982,0
elie wiesel,Night,1982,8,4.337016574585635,181,1982,0
elie wiesel,Night,1982,9,3.1875,16,1982,0
elie wiesel,SOULS ON FIRE,1982,10,0,2,1982,0
elie wiesel,The Accident,1982,11,8,1,1982,0
elie wiesel,SOULS ON FIRE,1982,12,2.6,5,1982,0
elie wiesel,Five Biblical Portraits,1983,13,0,1,1982,1
elie wiesel,Somewhere a Master,1984,14,0,1,1983,1
elie wiesel,MESSENGERS OF GOD,1985,15,0,2,1984,1
elie wiesel,Legends of Our Time,1987,16,0,2,1985,2
elie wiesel,"The Night Trilogy : Night, Dawn, The Accident",1987,17,3.3333333333333335,3,1987,0
elie wiesel,Twilight,1988,18,3.6,5,1987,1
elie wiesel,The Six Days of Destruction: Meditations Toward Hope,1988,19,0,2,1988,0
elie wiesel,The Fifth Son,1989,20,0,3,1988,1
elie wiesel,A Journey of Faith,1990,21,8,1,1989,1
elie wiesel,A Journey of Faith,1990,22,0,1,1990,0
elie wiesel,"Sages and Dreamers: Biblical, Talmudic, and Hasidic Portraits and Legends",1991,23,0,1,1990,1
elie wiesel,The Forgotten,1992,24,9,1,1991,1
elie wiesel,PASSOVER HAGGADAH: AS COMMENTED UPON BY ELIE WIESEL AND ILLUSTATED BY MARK PODWAL,1993,25,5,1,1992,1
elie wiesel,All Rivers Run to the Sea : Memoirs,1995,26,0,1,1993,2
elie wiesel,The Trial of God,1995,27,4,2,1995,0
elie wiesel,All Rivers Run to the Sea,1995,28,8,1,1995,0
elie wiesel,All Rivers Run to the Sea: Memoirs,1996,29,3.857142857142857,7,1995,1
elie wiesel,Alle FlÃ?Â¼sse flieÃ?Â?en ins Meer.,1997,30,9,1,1996,1
elie wiesel,The Accident,1999,31,0,2,1997,2
elie wiesel,The Testament,1999,32,0,1,1999,0
elie wiesel,"And the Sea Is Never Full: Memoirs, 1969",2000,33,8,1,1999,1
elie wiesel,The Oath,2001,34,5,1,2000,1
elie wiesel,The Judges: A Novel,2002,35,0,1,2001,1
elie wiesel,Die Richter.,2003,36,5,1,2002,1
elinor j. brecher,Schindler's Legacy: True Stories of the List Survivors,1994,2,5,4,1994,0
elinor j. brecher,Ich stand auf Schindlers Liste. Lebenswege der Geretteten.,1995,3,0,3,1994,1
elinor lipman,Then She Found Me,1991,2,2.2758620689655173,29,1988,3
elinor lipman,WAY MEN ACT,1992,3,1,7,1991,1
elinor lipman,The Way Men Act: A Novel,1993,4,3.3636363636363638,11,1992,1
elinor lipman,Isabel's Bed,1995,5,3.6666666666666665,6,1993,2
elinor lipman,Isabel'S Bed,1996,6,1.6875,16,1995,1
elinor lipman,Isabel's Bed,1998,7,3.2439024390243905,41,1996,2
elinor lipman,The Inn at Lake Devine: A Novel,1998,8,2.5714285714285716,7,1998,0
elinor lipman,The Ladies' Man,1999,9,2.230769230769231,13,1998,1
elinor lipman,The Inn at Lake Devine,1999,10,3.5416666666666665,48,1999,0
elinor lipman,The Ladies' Man,2000,11,2.6,20,1999,1
elinor lipman,The Dearly Departed,2001,12,0,3,2000,1
elinor lipman,The Dearly Departed,2001,13,0,1,2001,0
elinor lipman,The Dearly Departed: A Novel,2002,14,2,3,2001,1
elinor lipman,The Pursuit of Alice Thrift,2003,15,1.8125,16,2002,1
eliot wigginton,Foxfire 2 (Foxfire (Paperback)),1973,2,4.8,5,1972,1
eliot wigginton,Foxfire 3 (Foxfire (Paperback)),1975,3,2.5,2,1973,2
eliot wigginton,Foxfire 4 (Foxfire (Paperback)),1977,4,6,3,1975,2
eliot wigginton,Foxfire 5 (Foxfire (Paperback)),1979,5,0,2,1977,2
eliot wigginton,Foxfire 6 (Foxfire (Paperback)),1980,6,4.333333333333333,3,1979,1
eliot wigginton,Sometimes a Shining Moment: The Foxfire Experience,1985,7,2,1,1980,5
eliot wigginton,SOMETIMES A SHINING MOMENT,1986,8,0,1,1985,1
elisabeth borchers,Das Buch der Liebe: Gedichte u. Lieder (Insel Taschenbuch ; 82),1974,2,0,1,1973,1
elise ford,"Frommer's Washington, D.C. from $60 a Day (9th Ed)",1997,2,0,1,1990,7
elissa wald,Holding Fire: A Love Story,2001,2,0,1,1998,3
eliza haywood,The History of Miss Betsy Thoughtless (World's Classics),1997,2,8,1,1995,2
eliza haywood,Love in Excess (second edition),2000,3,2,2,1997,3
elizabeth a. lynn,Watchtower,1981,2,0,1,1981,0
elizabeth a. lynn,Northern Girl,1981,3,4,4,1981,0
elizabeth a. lynn,Sardonyx Net,1982,4,4,2,1981,1
elizabeth a. lynn,Watchtower,1982,5,5,4,1982,0
elizabeth a. lynn,Sardonyx Net,1982,6,0,1,1982,0
elizabeth a. lynn,Northern Girl,1983,7,0,2,1982,1
elizabeth a. lynn,Dancers of Arun,1983,8,0,4,1983,0
elizabeth a. lynn,Watchtower,1983,9,0,4,1983,0
elizabeth a. lynn,The Sardonyx Net,1985,10,0,1,1983,2
elizabeth a. lynn,"Watchtower (Chronicles of Tornor, Book 1)",1986,11,3.5,2,1985,1
elizabeth a. lynn,Dragon's Winter,1998,12,0,1,1986,12
elizabeth a. lynn,Dragon's Winter,1999,13,3.2,5,1998,1
elizabeth a. lynn,"Watchtower (Chronicles of Tornor, No 1)",1999,14,0,1,1999,0
elizabeth a. lynn,Dragon's Treasure,2004,15,9,1,1999,5
elizabeth a. ryan,How to Write Better Book Reports (Student Survival Power),1991,2,0,1,1989,2
elizabeth a. ryan,How to Write Better Book Reports (Student Survival Power),1991,3,0,2,1991,0
elizabeth alston,Biscuits and Scones: 62 Recipes from Breakfast Biscuits to Homey Desserts,1988,2,7,1,1985,3
elizabeth alston,Pancakes and Waffles,1993,3,10,1,1988,5
elizabeth anders,Sizzle Cleans Up (The Puzzle Place),1997,2,0,1,1996,1
elizabeth anders,The Flower Princesses: Includes 20 Glitter Tattoos (Glitter Tattoos),1998,3,0,1,1997,1
elizabeth b. coker,Blood Red Roses,1978,2,0,1,1977,1
elizabeth barrett browning,Sonnets from the Portuguese and Other Love Poems,1990,2,4,2,1986,4
elizabeth barrett browning,Sonnets from the Portuguese and Other Poems (Dover Thrift Editions),1992,3,4.846153846153846,13,1990,2
elizabeth barrett browning,Selected Poems,1992,4,0,1,1992,0
elizabeth barrett browning,Love sonnets,1993,5,8,1,1992,1
elizabeth barrett browning,Aurora Leigh and Other Poems (Penguin Classics),1996,6,6,1,1993,3
elizabeth barrett browning,Sonnets from the Portuguese,1997,7,9.25,4,1996,1
elizabeth dewberry vaughn,Break the Heart of Me,1994,2,7,1,1990,4
elizabeth diefendorf,The New York Public Library's Books of the Century,1997,2,7,3,1996,1
elizabeth ehrlich,Miriam's Kitchen: A Memoir,1998,2,1.3333333333333333,6,1997,1
elizabeth elliot,Let Me Be a Woman,1999,2,0,1,1989,10
elizabeth elliot,Let Me Be a Woman,1999,3,7,1,1999,0
elizabeth enright,Saturdays,1987,2,0,1,1987,0
elizabeth enright,Spiderweb for Two,1987,3,10,1,1987,0
elizabeth enright,Return to Gone-Away,1992,4,0,1,1987,5
elizabeth enright,The Four-Story Mistake,1997,5,3.75,4,1992,5
elizabeth enright,Return to Gone-Away,2000,6,5,1,1997,3
elizabeth enright,Gone-Away Lake (Gone-Away Lake Books (Hardcover)),2000,7,10,1,2000,0
elizabeth enright,Gone-Away Lake (Gone-Away Lake Books (Paperback)),2000,8,4.75,4,2000,0
elizabeth enright,Then There Were Five,2002,9,0,2,2000,2
elizabeth enright,The Four-Story Mistake,2002,10,0,1,2002,0
elizabeth enright,The Saturdays,2002,11,8,1,2002,0
elizabeth enright,Spiderweb for Two: A Melendy Maze,2002,12,0,1,2002,0
elizabeth forsythe hailey,Life Sentences,1982,2,10,1,1979,3
elizabeth forsythe hailey,"Joanna's Husband, and David's Wife (G.K. Hall large print book series)",1986,3,0,1,1982,4
elizabeth forsythe hailey,Joanna's Husband and David's Wife,1986,4,0,2,1986,0
elizabeth forsythe hailey,Life Sentences,1987,5,3.5,2,1986,1
elizabeth forsythe hailey,A Woman of Independent Means,1990,6,2.4375,16,1987,3
elizabeth forsythe hailey,Home Free: A Novel,1991,7,0,1,1990,1
elizabeth forsythe hailey,Home Free,1991,8,0.7142857142857143,7,1991,0
elizabeth forsythe hailey,A Woman of Independent Means,1998,9,1.5,8,1991,7
elizabeth hollinger,Legend of Zelda: Ocarina of Time: Prima's Official Strategy Guide,1998,2,7,2,1998,0
elizabeth hollinger,Dragon Ball Z: Legacy of Goku : Prima's Official Strategy Guide (Prima's Official Strategy Guides),2002,3,8,1,1998,4
elizabeth king,The Pumpkin Patch (Picture Puffins),1996,2,9,1,1995,1
elizabeth lane,"Birds Of Passage (Harlequin Historical, No 692)",1991,2,0,2,1989,2
elizabeth lane,Mad As Rabbits,1991,3,0,1,1991,0
elizabeth lane,"Moonfire (Harlequin Historical, No 150)",1992,4,0,2,1991,1
elizabeth lane,Mckenna'S Promise (Harlequin Historical No 216),1994,5,0,2,1992,2
elizabeth lane,"Lydia (Harlequin Historical, No 302)",1995,6,4,2,1994,1
elizabeth lane,"Apache Fire (Harlequin Historicals, 436)",1998,7,2.3333333333333335,3,1995,3
elizabeth lane,"Shawnee Bride (Harlequin Historicals, 492)",1999,8,3.8,5,1998,1
elizabeth lane,"Bride On The Run (American Historical Series, No 546)",2001,9,0,1,1999,2
elizabeth lane,"My Lord Savage (Harlequin Historical Series, No. 569)",2001,10,1.1428571428571428,7,2001,0
elizabeth lane,"Navajo Sunrise (Harlequin Historical, No. 608)",2002,11,0,5,2001,1
elizabeth lane,Wyoming Widow,2003,12,0,2,2002,1
elizabeth longford,Oxford Book of Royal Anecdotes,1991,2,3,2,1989,2
elizabeth mayne,Lord Of The Isle (Harlequin Historical),1996,2,1,7,1995,1
elizabeth mayne,"Man Of The Mist (Harlequin Historical, No 313)",1996,3,1.2,5,1996,0
elizabeth mayne,"Lady Of The Lake (Harlequin Historical, No 980)",1997,4,0,8,1996,1
elizabeth mayne,"Highlander'S Maiden (Harlequin Historicals, No. 449)",1999,5,0,1,1997,2
elizabeth sims,Damn Straight : A Lillian Byrd Crime Story,2003,2,0,1,2002,1
elizabeth spencer,The Light in the Piazza (Penguin Short Fiction),1986,2,6,2,1984,2
elizabeth spencer,The Voice at the Back Door,1986,3,0,2,1986,0
elizabeth spencer,Fire in the Morning,1987,4,0,1,1986,1
elizabeth spencer,Jack of Diamonds: And Other Stories,1988,5,7,1,1987,1
elizabeth spencer,The Stories of Elizabeth Spencer (Contemporary American Fiction),1990,6,0,2,1988,2
elizabeth spencer,Landscapes of the Heart: A Memoir,1998,7,0,2,1990,8
elizabeth spencer,The Southern Woman: New and Selected Fiction (Modern Library),2001,8,10,1,1998,3
elizabeth willey,A Sorcerer and a Gentleman (Sorcerer &amp; a Gentleman),1996,2,0,1,1994,2
elizabeth willey,The Price of Blood and Honor,1997,3,6,1,1996,1
elizabeth wood,"Reef Fishes, Corals and Invertebrates of the South China Sea (Reef Fishes, Corals and Invertebrates)",2002,2,7,1,1988,14
ella thorp ellis,The Year of My Indian Prince,2002,2,7,1,1996,6
elle eggels,Das Haus der sieben Schwestern.,2001,2,5,1,1998,3
elle eggels,The House of the Seven Sisters : A Novel of Food and Family,2002,3,0,1,2001,1
elle eggels,Das Haus der sieben Schwestern.,2002,4,0,1,2002,0
elle eggels,The House of the Seven Sisters : A Novel of Food and Family,2003,5,4,2,2002,1
ellen  godfrey,GEORGIA DISAPPEARED,1993,2,3,1,1989,4
ellen b. jackson,"Autumn Equinox, The",2000,2,9.5,2,1994,6
ellen bass,Courage to Heal: A Guide for Women Survivors of Child Sexual Abuse,1988,2,4.166666666666667,6,1983,5
ellen bass,I Never Told Anyone : Writings by Women Survivors of Child Sexual Abuse,1991,3,2.5,2,1988,3
ellen bass,The Courage To Heal : A Guide For Women Survivors of Child Sexual Abuse,1992,4,4,2,1991,1
ellen bass,The Courage to Heal - Third Edition - Revised and Expanded : A Guide for Women Survivors of Child Sexual Abuse,1994,5,3.1666666666666665,6,1992,2
ellen bass,"Mules of Love: Poems (American Poets Continuum, 73)",2002,6,5,1,1994,8
ellen fitzgerald,Julia's Portion,1988,2,0,1,1986,2
ellen goodman,Close to Home,1981,2,0,1,1979,2
ellen goodman,At Large,1981,3,0,1,1981,0
ellen goodman,Turning Points,1982,4,0,2,1981,1
ellen goodman,At Large,1983,5,9,1,1982,1
ellen goodman,Keeping in Touch,1985,6,0,5,1983,2
ellen goodman,Keeping in Touch,1987,7,0,1,1985,2
ellen goodman,I Know Just What You Mean: The Power of Friendship in Women's Lives,2000,8,1.8,5,1987,13
ellen goodman,I Know Just What You Mean: The Power of Friendship in Women's Lives,2001,9,0,1,2000,1
ellen l. buell,A Family Treasury of Little Golden Books: 46 Best-Loved Stories,2001,2,10,2,1982,19
ellen rudin,The three billy goats Gruff (A First little golden book),1992,2,3,7,1984,8
ellen siever,"Linux in a Nutshell, 2nd Edition (O'Reilly Nutshell)",1999,2,0,3,1998,1
ellen siever,LINUX in A Nutshell: A Desktop Quick Reference (3rd Edition),2000,3,0,1,1999,1
ellen stoll walsh,Brunus and the New Bear,1993,2,8,1,1991,2
ellen stoll walsh,Mouse Paint,1995,3,10,2,1993,2
ellis weiner,Howard the Duck,1986,2,1.3333333333333333,3,1984,2
ellis weiner,Northern Exposure,1992,3,0,1,1986,6
ellis weiner,Letters from Cicely,1992,4,3.4545454545454546,11,1992,0
ellis weiner,The Northern Exposure Cookbook: A Community Cookbook from the Heart of the Alaskan Riviera,1993,5,10,1,1992,1
ellis weiner,"Drop Dead, My Lovely",2004,6,9,1,1993,11
else mã?â¼ller,Du fÃ?Â¼hlst die Wunder nur in dir.,1993,2,0,1,1985,8
else mã?â¼ller,Du spÃ?Â¼rst unter deinen FÃ?Â¼Ã?Â?en das Gras. Autogenes Training in Phantasie- und MÃ?Â¤rchenreisen.,2000,3,10,1,1993,7
else mã?â¼ller,Inseln der Ruhe.,2001,4,0,1,2000,1
elsie sechrist,Dreams: Your Magic Mirror,1988,2,5,1,1972,16
elspeth huxley,The Mottled Lizard,1982,2,0,2,1982,0
elspeth huxley,Out in the Midday Sun: My Kenya,1988,3,9,1,1982,6
elspeth huxley,Murder on Safari (Penguin Crime Monthly),1990,4,0,3,1988,2
elwood reid,If I Don't Six,1999,2,0,1,1999,0
elwood reid,What Salmon Know,2000,3,0,2,1999,1
elwood reid,Midnight Sun,2000,4,0,2,2000,0
emer martin,More Bread or I'll Appear,2000,2,0,2,1997,3
emile zola,L' Assommoir,1955,2,9,1,1954,1
emile zola,Germinal,1956,3,6,1,1955,1
emile zola,The Masterpiece (Ann Arbor Paperbacks),1968,4,7,1,1956,12
emile zola,L'Assommoir (Penguin Classics),1970,5,5.75,4,1968,2
emile zola,L'Assommoir,1971,6,8,1,1970,1
emile zola,Germinal,1971,7,2.25,4,1971,0
emile zola,Au bonheur des dames,1971,8,4.25,4,1971,0
emile zola,Le Ventre de Paris,1971,9,6.5,2,1971,0
emile zola,Au Bonheur Des Dames,1971,10,0,1,1971,0
emile zola,Nana. (Penguin Classics),1972,11,3.5,4,1971,1
emile zola,La BÃªte Humaine,1972,12,4,2,1972,0
emile zola,The Debacle (The Penguin Classics),1973,13,0,1,1972,1
emile zola,L'Assommoir,1977,14,6,1,1973,4
emile zola,La Bete Humaine,1977,15,7.5,2,1977,0
emile zola,La CurÃ?Â©e,1978,16,8,1,1977,1
emile zola,Le Ventre de Paris,1979,17,0,1,1978,1
emile zola,The Earth (Penguin Classics),1980,18,2.6666666666666665,3,1979,1
emile zola,Therese Raquin (Penguin Classics),1981,19,5.555555555555555,9,1980,1
emile zola,Pot-Bouille,1982,20,0,1,1981,1
emile zola,Nana,1983,21,0,2,1982,1
emile zola,La Faute de l'abbÃ?Â© Mouret,1991,22,10,1,1983,8
emile zola,La ConquÃ?Âªte de Plassans,1991,23,0,1,1991,0
emile zola,Germinal,1991,24,0,1,1991,0
emile zola,Nana (The World's Classics),1992,25,8,1,1991,1
emile zola,The Masterpiece (The World's Classics),1993,26,5,1,1992,1
emile zola,Germinal (The World's Classics),1993,27,0,1,1993,0
emile zola,Pot-Bouille,1993,28,0,1,1993,0
emile zola,Germinal (Movie Tie in),1994,29,0,3,1993,1
emile zola,L'Attaque du moulin,1995,30,0,1,1994,1
emile zola,VÃ?Â©ritÃ?Â©,1996,31,10,1,1995,1
emile zola,La Faute De L'abbe Mouret,1996,32,5,1,1996,0
emile zola,Germinal (Oxford World's Classics),1998,33,8,5,1996,2
emile zola,L'Assommoir,1998,34,6,1,1998,0
emile zola,Jacques D'Amour L'inondation,1998,35,8,1,1998,0
emile zola,Au Bonheur des Dames,1998,36,0,1,1998,0
emile zola,The Ladies' Paradise (Oxford World's Classics (Paperback)),1998,37,10,1,1998,0
emile zola,The Masterpiece (Oxford World's Classics),1999,38,0,2,1998,1
emile zola,L'Assommoir (Oxford World's Classics),1999,39,4,2,1999,0
emile zola,Le Venture de Paris (World Classics),1999,40,7,1,1999,0
emile zola,Nana [French],1999,41,0,1,1999,0
emile zola,La Terre,1999,42,4,1,1999,0
emile zola,La Bete Humaine (World Classics),1999,43,2.5,2,1999,0
emile zola,"Jacques Damour, suivi de \Le Capitaine Burle""""""""",2001,44,0,1,1999,2
emile zola,Truth (Literary Classics Series),2001,45,10,1,2001,0
emile zola,Collected Works of Emile Zola,2001,46,0,2,2001,0
emile zola,Das Geld.,2001,47,9,1,2001,0
emile zola,Nana.,2002,48,0,1,2001,1
emile zola,Das Werk.,2002,49,0,2,2002,0
emile zola,Au Bonheur Des Dames (The Ladies' Delight): The Ladies' Delight (Penguin Classics),2002,50,0,1,2002,0
emile zola,For a Night of Love,2002,51,9,1,2002,0
emilie rose,"Cowboy's Million-Dollar Secret (Silhouette Desire, 1542)",2003,2,2.5,4,2002,1
emilie rose,The Cowboy's Baby Bargain  The Baby Bank,2003,3,3.3333333333333335,3,2003,0
emilie rose,A Passionate Proposal (Silhouette Desire),2004,4,4.5,2,2003,1
emilio calderã³n,Retrato de un detective enamorado (Espacio abierto),1997,2,5,1,1996,1
emily fox gordon,Mockingbird Years: A Life in and Out of Therapy,2001,2,0,2,2000,1
emily james,Aladdin's quest (Disney's Aladdin series),1993,2,0,1,1992,1
emily neye,Water (All Aboard Science Reader),2002,2,0,1,1999,3
emily prager,Clea and Zeus Divorce/91207 (Vintage Contemporaries (Paperback)),1987,2,1.4444444444444444,9,1984,3
emily prager,"A Visit from the Footbinder, and Other Stories (Vintage Contemporaries)",1987,3,0,2,1987,0
emily prager,Eve's Tattoo (Vintage Contemporaries),1992,4,5.25,4,1987,5
emily prager,Roger Fishbite: A Novel,1999,5,2.3333333333333335,3,1992,7
emily prager,Wuhu Diary: On Taking My Adopted Daughter Back to Her Hometown in China,2002,6,0,1,1999,3
emily thompson,Just Like Ernie (Sesame Street Growing Up Books),1988,2,0,1,1988,0
emily thompson,Big Birds Square Meal: Stories About Shapes and Colors (Sesame Street Get Ready),1988,3,0,1,1988,0
emily thompson,Imagine...a Million Kittens for Elmo (Golden/Sesame Street Imagine Books),1993,4,0,1,1988,5
emma lathen,LONGER THREAD    M (Inner Sanctum Mystery),1972,2,0,1,1969,3
emma lathen,DEATH SHALL OVERCM,1981,3,4.75,4,1972,9
emma lathen,LONGER THE THREAD,1982,4,4.5,2,1981,1
emma lathen,By Hook or by Crook,1983,5,2.6666666666666665,3,1982,1
emma lathen,SWEET AND LOW,1983,6,4.25,4,1983,0
emma lathen,BANKING ON DEATH,1983,7,5.333333333333333,3,1983,0
emma lathen,GREEN GROW DOLLARS,1983,8,4,4,1983,0
emma lathen,STITCH IN TIME,1983,9,0,1,1983,0
emma lathen,"Banking on Murder: Three by Emma Lathen : Death Shall Overcome, Murder Against the Grain, a Stitch in Time",1984,10,0,1,1983,1
emma lathen,WHEN IN GREECE,1985,11,4.5,2,1984,1
emma lathen,Murder Against the Grain (Portway Large Print),1986,12,5,1,1985,1
emma lathen,MURDER MAKE WHEELS,1987,13,9,2,1986,1
emma lathen,Something in the Air,1988,14,0,1,1987,1
emma lathen,LONGER THE THREAD,1988,15,1.25,4,1988,0
emma lathen,SOMETHING IN THE AIR,1989,16,2.6666666666666665,3,1988,1
emma lathen,East Is East,1991,17,0,1,1989,2
emma lathen,East Is East/a John Putnam Thatcher Mystery,1994,18,0,2,1991,3
emma lathen,Accounting for Murder (Otto Penzler's Classic American Mystery Library),1995,19,0,1,1994,1
emma lathen,Right on the Money : Right on the Money (John Putnam Thatcher Mysteries),1995,20,0,4,1995,0
emma lathen,Brewing Up a Storm: A John Thatcher Mystery,1996,21,0,2,1995,1
emma lathen,A Shark out of Water (John Putnam Thatcher Mystery),1998,22,0,2,1996,2
emma lathen,Brewing up a Storm (John Putnam Thatcher Mysteries),1998,23,0,2,1998,0
emma sinclair,Her Father's House,1997,2,0,1,1996,1
emmanuel carrã?â¨re,Je suis vivant et vous Ã?Âªtes morts,1997,2,8.5,2,1987,10
emmanuel carrã?â¨re,La Classe de neige,1997,3,4.6,10,1997,0
ephraim kishon,Undank ist der Welten Lohn. Ein satirischer Nachruf.,1993,2,0,1,1992,1
ephraim kishon,Kishon fÃ?Â¼r Steuerzahler. Eine satirische Bilanz.,1994,3,5,3,1993,1
ephraim kishon,"Arche Noah, Touristenklasse. Neue Satiren aus Israel.",1995,4,1.6,5,1994,1
ephraim kishon,Abraham kann nichts dafÃ?Â¼r. 66 neue Satiren.,1997,5,4.666666666666667,3,1995,2
ephraim kishon,"Total verkabelt. Satirisches um Presse, Funk und Fernsehen.",1997,6,7,1,1997,0
ephraim kishon,Mein Kamm. Satirischer Roman.,1997,7,0,1,1997,0
ephraim kishon,"Salomos Urteil, zweite Instanz. Neue Satiren.",1998,8,4.5,2,1997,1
ephraim kishon,Der Blaumilchkanal.,1998,9,3.5,2,1998,0
ephraim kishon,Kishon fÃ?Â¼r unterwegs. Weltreisen leicht gemacht,1998,10,0,1,1998,0
ephraim kishon,Kishons beste Reisegeschichten. Eine Weltreise des Humors in 13 LÃ?Â¤nder.,1998,11,0,2,1998,0
ephraim kishon,Bekenntnisse eines perfekten Ehemannes. Satiren.,1998,12,0,1,1998,0
ephraim kishon,Paradies neu zu vermieten.,1998,13,9,1,1998,0
ephraim kishon,Zu AuskÃ?Â¼nften stets bereit. GroÃ?Â?druck. Eine Auswahl aus Kishons besten Geschichten.,1999,14,7,1,1998,1
ephraim kishon,Beste Tiergeschichten.,2000,15,0,1,1999,1
ephraim kishon,"Wers glaubt, wird selig. Politische Satiren.",2000,16,0,1,2000,0
ephraim kishon,Im neuen Jahr wird alles anders. AusgewÃ?Â¤hlte Satiren.,2000,17,7,1,2000,0
ephraim kishon,Beste Autofahrergeschichten.,2001,18,7,1,2000,1
ephraim kishon,Kishons beste Familiengeschichten.,2001,19,10,1,2001,0
ephraim kishon,Auch die Waschmaschine ist nur ein Mensch. Die besten Technikgeschichten.,2001,20,7,1,2001,0
eric c. evans,Misconstrued (Sam McKall Mysteries),2003,2,0,4,2000,3
eric c. fry,The Complete Book of Knots &amp; Ropework,1996,2,0,1,1982,14
eric foner,Nothing but Freedom: Emancipation and Its Legacy (Walter Lynwood Fleming Lectures in Southern History (Paperback)),1984,2,10,1,1977,7
eric foner,A Short History of Reconstruction,1990,3,5,2,1984,6
eric foner,"Free Soil, Free Labor, Free Men: The Ideology of the Republican Party Before the Civil War",1995,4,10,1,1990,5
eric garcia,Anonymous Rex: A Detective Story,2001,2,4.375,8,1999,2
eric garcia,Casual Rex: A Novel,2001,3,5.705882352941177,17,2001,0
eric garcia,Anonymus Rex.,2002,4,3.5,2,2001,1
eric garcia,Casual Rex: A Novel,2002,5,6,6,2002,0
eric garcia,Matchstick Men : A Novel of Petty Crimes,2002,6,7.25,4,2002,0
eric garcia,Anonymous Rex: A Detective Story,2003,7,2.1666666666666665,6,2002,1
eric garcia,Matchstick Men : A Novel About Grifters with Issues,2003,8,4,3,2003,0
eric garcia,Cassandra French's Finishing School for Boys : A Novel,2004,9,5,5,2003,1
eric garcia,Hot and Sweaty Rex : A Dinosaur Mafia Mystery,2004,10,8,1,2004,0
eric j. chaisson,The Hubble Wars: Astrophysics Meets Astropolitics in the Two-Billion-Dollar Struggle over the Hubble Space Telescope,1995,2,0,1,1994,1
eric james fullilove,Blowback,2001,2,0,1,1996,5
eric kotani,The Legacy of Prometheus,2002,2,0,1,1999,3
eric nylund,The Fall of Reach (Halo),2001,2,3.6,5,1995,6
eric nylund,First Strike (Halo),2003,3,0,1,2001,2
eric r. wolf,Peasant Wars of the Twentieth Century,1999,2,0,1,1997,2
eric rucker eddison,The Worm Ouroboros,1999,2,0,1,1973,26
eric w. johnson,A Treasury of Humor II (Treasury of Humor),1994,2,0,1,1990,4
eric weiner,Black Out! (Ghostwriter),1993,2,3.3333333333333335,3,1992,1
eric weiner,Steer Clear of Haunted Hill (Ghostwriter),1993,3,0,3,1993,0
eric weiner,X-Men: Enter Magneto/Based on Teleplays by Mark Edward Edens (Step Into Reading : a Step 3 Book),1994,4,4,2,1993,1
eric weiner,Jack and Jill: Nursery Crimes,1995,5,0,2,1994,1
eric weiner,"Pat-A-Cake, Pat-A-Cake (Nursery Crimes)",1995,6,7,1,1995,0
eric weiner,There Was an Old Woman (Nursery Crimes),1995,7,0,1,1995,0
eric weiner,Death Is Watching (H Thriller),1995,8,10,1,1995,0
eric weiner,Disney's Mighty Ducks: Phil in the Blank (A Golden look-look book),1997,9,0,2,1995,2
eric weiner,"Door of Death (Fear Street Sagas , No 15)",1998,10,0,2,1997,1
eric wiggin,Texas Rodeo Showdown (Hannah's Island),1998,2,0,2,1995,3
eric wilson,Ghost of Lunenburg Manor,1993,2,0,2,1984,9
eric wilson,Escape from the Big Muddy,1998,3,10,1,1993,5
eric wilson,Murder on the Canadian: A Tom Austen Mystery,1999,4,3.5,2,1998,1
eric wilson,"Pesadilla En Vancuver (Serie Naranja, 17)",2000,5,0,1,1999,1
eric wilson,Code Red at the Supermall (Eric Wilson Mysteries),2001,6,8,1,2000,1
eric wilson,The Emily Carr Mystery,2001,7,10,1,2001,0
eric wilson,Dark to Mortal Eyes,2004,8,10,1,2001,3
erich neumann,The Origins and History of Consciousness (Mythos Books),1995,2,0,1,1971,24
erich von daniken,The Gold of the Gods,1974,2,0,2,1973,1
erich von daniken,Pathways to the Gods: The Stones of Kiribati,1984,3,0,1,1974,10
erich von daniken,Chariots of the Gods?,1987,4,0,1,1984,3
erich von daniken,The Return of the Gods: Evidence of Extraterrestrial Visitations,1997,5,0,1,1987,10
erich von daniken,The Return of the Gods : Evidence of Extraterrestrial Visitations,1998,6,0,2,1997,1
erich von daniken,Chariots of the Gods: Unsolved Mysteries of the Past,1999,7,0,9,1998,1
erich von daniken,Gods from Outer Space,2000,8,3.3333333333333335,3,1999,1
erich von daniken,The Return of the Gods: Evidence of Extraterrestrial Visitations,2002,9,0,2,2000,2
erich von daniken,The Gods Were Astronauts: Evidence of the True Identities of the Old 'Gods',2003,10,7.5,2,2002,1
erich von daniken,"Gods from Outer Space: Return to the Stars, or Evidence for the Impossible",2004,11,0,1,2003,1
erick wujcik,Teenage Mutant Ninja Turtles and Other Strangeness,1985,2,7.5,2,1985,0
erick wujcik,Guide to the Universe/Eastman and Laird's Teenage Mutant Ninja Turtles,1987,3,7,2,1985,2
erick wujcik,Mutants Down Under (Teenage Mutant Ninja Turtles and Other Strangeness Role Playing Game Supplement),1988,4,7,1,1987,1
erick wujcik,Transdimensional/Teenage Mutant Ninja Turtles,1989,5,9,1,1988,1
erick wujcik,After the Bomb Role-Playing Game,1990,6,9,1,1989,1
erick wujcik,Road Hogs (Role-Playing Game Adventure/Source Book),1990,7,7,1,1990,0
erick wujcik,Amber Diceless Role-Playing: Diceless Role-Playing System,1992,8,9,1,1990,2
erick wujcik,Ninjas and Superspies,1994,9,7,1,1992,2
erick wujcik,Shadow Knight,1995,10,7,1,1994,1
erik orsenna,L'exposition coloniale,1995,2,4,3,1993,2
erik orsenna,Deux Ã?Â©tÃ?Â©s,1997,3,8,2,1995,2
erik orsenna,Grand amour,1997,4,0,1,1997,0
erik orsenna,Longtemps: Roman,1998,5,10,1,1997,1
erik orsenna,Une comÃ?Â©die franÃ?Â§aise,1998,6,0,1,1998,0
erik orsenna,Longtemps,1999,7,0,1,1998,1
erik orsenna,La Historia del Mundo En Nueve Guitarras,2000,8,0,1,1999,1
erik orsenna,La Grammaire est une chanson douce,2001,9,5,12,2000,1
erik orsenna,La grammaire est une chanson douce,2003,10,5.461538461538462,13,2001,2
erika knight,Simple Knits for Cherished Babies,2001,2,10,1,2000,1
erna rowe,Giant Dinosaurs,1984,2,5,1,1973,11
ernest becker,Denial of Death,1975,2,0,1,1971,4
ernest becker,DENIAL OF DEATH,1985,3,3,3,1975,10
ernest becker,The DENIAL OF DEATH,1997,4,5,2,1985,12
ernest callenbach,Ecotopia,1975,2,3.25,4,1975,0
ernest callenbach,Ecotopia Emerging,1981,3,9,1,1975,6
ernest callenbach,Ecotopia,1982,4,3.5,2,1981,1
ernest callenbach,Ecotopia,1982,5,0,1,1982,0
ernest callenbach,Ecotopia,1990,6,4.666666666666667,15,1982,8
ernest callenbach,Ã?kotopia: Notizen und Reportagen von William Weston aus dem Jahre 1999 [sic],1990,7,4,1,1990,0
ernest callenbach,Living Cheaply With Style: Live Better and Spend Less,1992,8,7,1,1990,2
ernest matthew mickler,"Sinkin Spells, Hot Flashes, Fits and Cravins",1988,2,7,1,1986,2
ernest thayer,Casey at the Bat,1988,2,10,1,1987,1
ernst junger,El Tirachinas (Andanzas),2002,2,7,1,1996,6
erri de luca,In alto a sinistra (I narratori/Feltrinelli),1994,2,9,1,1992,2
erri de luca,In alto a sinistra (Universale economica Feltrinelli),1995,3,4,6,1994,1
erri de luca,Alzaia (I narratori),1997,4,4.666666666666667,3,1995,2
erri de luca,Tre cavalli (I narratori/Feltrinelli),1999,5,0,1,1997,2
erri de luca,Trois chevaux,2001,6,2,5,1999,2
erri de luca,Trois chevaux,2002,7,2.5714285714285716,7,2001,1
erri de luca,Tre Cavalli,2002,8,4.555555555555555,9,2002,0
erri de luca,God's Mountain,2002,9,3.25,4,2002,0
erri de luca,Opera Sull'acqua E Altre Poesie,2002,10,4.5,6,2002,0
erri de luca,Montedidio,2002,11,8,1,2002,0
esmeralda santiago,When I Was Puerto Rican,1994,2,2.1666666666666665,18,1993,1
esmeralda santiago,America's Dream,1996,3,0,1,1994,2
esmeralda santiago,America's Dream,1997,4,1.75,4,1996,1
esmeralda santiago,Almost a Woman,1998,5,0,1,1997,1
esmeralda santiago,Casi una mujer,1999,6,7,1,1998,1
esmeralda santiago,Almost a Woman,1999,7,3.875,8,1999,0
esmeralda santiago,Las Mamis : Escritores latinos recuerdan a sus madres (Vintage Espa~nol),2001,8,0,1,1999,2
esther hautzig,Endless Steppe: Growing Up in Siberia,1987,2,9.5,2,1987,0
esther hautzig,The Endless Steppe : Growing Up in Siberia,1995,3,3.3333333333333335,3,1987,8
etgar keret,Gaza Blues. ErzÃ?Â¤hlungen.,2002,2,0,3,2001,1
etgar keret,"Pizzeria Kamikaze. Der Busfahrer, der Gott sein wollte.",2002,3,4,2,2002,0
eudora welty,The Ponder Heart,1967,2,0.6666666666666666,9,1965,2
eudora welty,The Wide Net And Other Stories,1974,3,8,1,1967,7
eudora welty,The optimist's daughter,1978,4,4.8,5,1974,4
eudora welty,Losing battles,1978,5,0,3,1978,0
eudora welty,The Robber Bridegroom,1978,6,0,1,1978,0
eudora welty,Delta Wedding: A Novel (A Harvest/Hbj Book),1979,7,2.727272727272727,11,1978,1
eudora welty,A Curtain of Green: and Other Stories,1979,8,1.8,5,1979,0
eudora welty,The Collected Stories of Eudora Welty,1982,9,1.25,8,1979,3
eudora welty,"One Writer's Beginnings (William E. Massey, Sr. Lectures in the History of American Civilization)",1984,10,0,3,1982,2
eudora welty,One Writer's Beginnings / Eudora Welty.,1985,11,3.142857142857143,7,1984,1
eudora welty,One Writer's Beginnings,1987,12,0.8571428571428571,7,1985,2
eudora welty,The Golden Apples,1988,13,1.1666666666666667,6,1987,1
eudora welty,The Optimist's Daughter,1990,14,3.6,15,1988,2
eudora welty,Losing Battles,1990,15,0,4,1990,0
eudora welty,Delta Wedding,1991,16,0,2,1990,1
eudora welty,One Writer's Beginnings,1995,17,2,5,1991,4
eudora welty,"Eudora Welty : Complete Novels: The Robber Bridegroom, Delta Wedding, The Ponder Heart, Losing Battles, The Optimist's Daughter (Library of America)",1998,18,3.5,2,1995,3
eudora welty,The Optimist's Daughter,2000,19,4.2,5,1998,2
eudora welty,On Writing (Modern Library),2002,20,0,1,2000,2
eudora welty,The Optimist's Daughter : A Novel By,2002,21,0,1,2002,0
eugene c. kennedy,Fixes,1989,2,2,4,1987,2
eugene fodor,Fodor's the Complete Guide to America's National Parks: The Official Visitor's Guide of the National Park Foundation (Serial),1998,2,8,1,1988,10
eugene jackson,German Made Simple,1965,2,4,2,1955,10
eugene jackson,"French made simple, (Made simple books)",1974,3,8,1,1965,9
eugene jackson,Spanish Made Simple (Made Simple),1984,4,5,3,1974,10
eugene jackson,French Made Simple,1987,5,0,1,1984,3
evaline ness,"Sam, Bangs, and Moonshine (Owlet Book)",1987,2,0,1,1966,21
evan h. rhodes,Bless This House,1982,2,7.5,2,1978,4
evan morris,The Word Detective: Solving the Mysteries Behind Those Pesky Words and Phrases,2000,2,2.5,2,1996,4
eve ensler,The Vagina Monologues: The V-Day Edition,2000,2,5.333333333333333,57,1998,2
eve ensler,The Vagina Monologues: The V-Day Edition,2000,3,3.6666666666666665,6,2000,0
eve ensler,Necessary Targets: A Story of Women and War,2001,4,2.6666666666666665,3,2000,1
evelyn anthony,Albatross,1983,2,0,1,1980,3
evelyn anthony,Albatross,1984,3,0,3,1983,1
evelyn anthony,The Company of Saints,1987,4,0,2,1984,3
evelyn anthony,A Place to Hide,1987,5,8,1,1987,0
evelyn anthony,Clandara,1987,6,0,1,1987,0
evelyn anthony,The Defector,1988,7,0,1,1987,1
evelyn anthony,The House of Vandekar,1989,8,0,1,1988,1
evelyn anthony,The House of Vandekar,1990,9,0,1,1989,1
evelyn anthony,The Relic,1991,10,0,2,1990,1
evelyn anthony,The Doll's House,1992,11,0,1,1991,1
evelyn anthony,The Doll's House,1993,12,0,1,1992,1
evelyn anthony,The Tamarind Seed,1995,13,0,1,1993,2
evelyn anthony,The Rendezvous,1997,14,0,1,1995,2
everett owens,Regeneration: A Novelization (X-Files (HarperCollins Age 12-Up)),1999,2,9,1,1997,2
everett owens,X Files YA #11 Howlers (X Files YA),1999,3,0,1,1999,0
everett owens,"X Files YA #14 Regeneration (X-Files, No 14 (Juvenile))",2000,4,0,2,1999,1
ezra jack keats,Regards to the man in the moon,1981,2,0,1,1962,19
ezra jack keats,The Snowy Day (Picture Puffin),1981,3,4.25,4,1981,0
ezra jack keats,Apt. 3,1983,4,0,1,1981,2
ezra jack keats,Hi! Cat!,1983,5,0,1,1983,0
ezra jack keats,Pet Show! (Reading Rainbow Book),1987,6,5,1,1983,4
ezra jack keats,Goggles,1987,7,0,1,1987,0
ezra jack keats,The Snowy Day,1996,8,0,3,1987,9
f. a. hayek,The Road to Serfdom,1994,2,2.5,4,1978,16
f. castle,No Flowers...just Lots of Joy,1996,2,4,2,1993,3
f. david peat,Superstrings and the Search for the Theory of Everything,1988,2,0,1,1987,1
f. david peat,Synchronicity: The Bridge Between Matter and Mind,1988,3,0,2,1988,0
f. david peat,"The Philosopher's Stone : Chaos, Synchronicity and the Hidden Order of the World",1991,4,0,1,1988,3
f. david peat,The Blackwinged Night: Creativity in Nature and Mind,2000,5,0,1,1991,9
f. n. monjo,The Drinking Gourd: A Story of the Underground Railroad (An I Can Read Book),1993,2,0,1,1980,13
f. ross holland,Lighthouses (Great Architecture),1997,2,10,2,1989,8
f. ross holland,Maryland Lighthouses of the Chesapeake Bay: An Illustrated History,1997,3,9,1,1997,0
faith richardson,The Peacock's Stone,2003,2,10,1,2003,0
faith richardson,Tree Root and River Rat,2003,3,7.5,2,2003,0
faith shannon,The Art and Craft of Paper,1994,2,0,2,1991,3
fanny morweiser,Das Medium: Roman,1991,2,2.5,2,1983,8
fanny morweiser,"Lalu lalula, arme kleine Ophelia. Eine unheimliche Liebesgeschichte.",1996,3,0,1,1991,5
fasa corporation,Rigger2: A Shadowrun Sourcebook (Shadowrun (Fasa Corp.)),1997,2,9,1,1990,7
fasa corporation,The Cannon Companion: A Shadowrun Sourcebook (Fasa),2000,3,10,1,1997,3
fasa corporation,Man &amp; Machine: Cyberware (Shadowrun),2000,4,10,1,2000,0
fasa corporation staff,Magic in the Shadows (Shadowrun RPG),1998,2,10,1,1988,10
fatema mernissi,Scheherazade Goes West,2002,2,3.3333333333333335,3,2001,1
fatema mernissi,Suenos En El Umbral,2003,3,9,1,2002,1
fc&a,"Super Life, Super Health",1999,2,0,1,1999,0
fc&a,"Nature's Prescription:  Foods, Vitamins, and Supplements That Prevent Disease",1999,3,7,1,1999,0
fc&a,"1,001 Home Health Remedies for Seniors",2000,4,0,1,1999,1
fc&a,"1,001 Perfectly Legal Ways to Get Exactly What You Want, When You Want It, Every Time",2000,5,0,2,2000,0
fc&a,"Fix It, Clean It and Make It Last: The Ultimate Guide to Making Your Household Items Last Forever",2000,6,2.6666666666666665,3,2000,0
federal aviation administration,Airplane Flying Handbook : FAA#8083-3,1999,2,10,1,1997,2
federal aviation administration,"Far/Aim 2002: Includes Federal Aviation Regulations Parts 1, 43, 61, 71, 73, 91, 97, 103, 105, 119, 135, 141, 142, Ntsb 830 and the Complete aeronaut",2001,3,10,1,1999,2
federal aviation administration,FAR/AIM 2003: Federal Aviation Regulations/Aeronautical Information Manual (FAR series),2002,4,10,1,2001,1
federal aviation administration,FAR/AIM 2004: Federal Aviation Regulations/Aeronautical Information Manual (FAR series),2003,5,10,1,2002,1
federal aviation administration,Private Pilot for Airplane Single-Engine Land and Sea Practical Test Standards: #FAA-S-8081-14A (single),2003,6,10,1,2003,0
fedor dostoevsky,Crime and Punishment (The World's Classics),1981,2,2.5,4,1976,5
fedor dostoevsky,Brothers Karamazov,1994,3,6.888888888888889,9,1981,13
felice holman,The Wild Children,1985,2,0,1,1975,10
felice holman,Slake's Limbo,1986,3,8,2,1985,1
felicitas hoppe,Pigafetta.,2000,2,0,1,1998,2
felicitas hoppe,"Paradiese, Ubersee: Roman",2003,3,0,1,2000,3
felix de azua,Diary of a Humiliated Man,1996,2,0,1,1993,3
felix de azua,El Aprendizaje de La Decepcion,1996,3,8,1,1996,0
felix de azua,Momentos Decisivos,2003,4,0,1,1996,7
fergus fleming,Barrow's Boys,2000,2,6,1,1998,2
fergus fleming,"Barrow's Boys: A Stirring Story of Daring, Fortitude, and Outright Lunacy",2001,3,0,1,2000,1
fergus fleming,Ninety Degrees North: the Quest for the North Pole,2002,4,9,1,2001,1
fergus fleming,Ninety Degrees North: The Quest for the North Pole,2002,5,0,1,2002,0
fernando alonso,El Faro Del Viento/the Lighthouse,1998,2,7,1,1983,15
fernando garcia de cortazar,Historia de Espana,1999,2,6,2,1994,5
fernando quiã±ones,Con el viento sur (SecciÃ³n Literatura),1996,2,5,1,1983,13
fernando sã¡nchez dragã³,El camino del corazÃ³n (ColecciÃ³n Autores espaÃ±oles e hispanoamericanos),1990,2,0,1,1986,4
fernando sã¡nchez dragã³,Discurso numantino: Segunda y Ãºltima salida de los ingeniosos hidalgos GÃ¡rgoris y Habidis (Serie BiografÃ­as y memorias),1995,3,0,1,1990,5
fernando vallejo,La Virgen De Los Sicarios,2001,2,6,1,2000,1
ferran torrent,GrÃ cies per la propina (Columna),1995,2,0,2,1988,7
ferran torrent,La mirada del tafur (ColÂ¨lecciÃ³ clÃ ssica),1997,3,1.6666666666666667,3,1995,2
ferran torrent,L'illa de l'HolandÃ¨s (ColÂ¨lecciÃ³ clÃ ssica),1998,4,7,2,1997,1
ferruccio parazzoli,"Principe Siddharta I, El - Las Cuatro Verdades",2000,2,0,1,1999,1
fiona carr,The Kissing Gate,2004,2,0,2,2003,1
fiona harrowe,Fountains of Glory,1979,2,0,1,1977,2
flann obrien,Irischer Lebenslauf. Eine arge Geschichte vom harten Leben.,2001,2,4.666666666666667,3,1992,9
fletcher pratt,The Compleat Enchanter,1980,2,2,5,1976,4
fletcher pratt,The Blue Star,1981,3,0,1,1980,1
flic everett,Fantasy Sex (Undercover Sex Tips),2002,2,0,1,2002,0
flora speer,Viking Passion,1992,2,7,1,1988,4
flora speer,A Time to Love Again (Timeswept Romance),1993,3,6,4,1992,1
flora speer,A Love Beyond Time (Timeswept),1994,4,0,6,1993,1
flora speer,Love Just in Time (Timeswept),1995,5,0,1,1994,1
flora speer,For Love and Honor,1995,6,0,1,1995,0
flora speer,Rose Red (Faerie Tale Romance),1996,7,5,1,1995,1
flora speer,Venus Rising (Futuristic Romance),1996,8,5,1,1996,0
flora speer,Lady Lure (Futuristic Romance),1996,9,4.25,4,1996,0
flora speer,Heart's Magic,1997,10,0,1,1996,1
flora speer,A Time to Love Again,1997,11,0,1,1997,0
flora speer,Destiny's Lovers (Futuristic Romance),1998,12,0,1,1997,1
flora speer,The Magician's Lover (Heartspell),1998,13,0,2,1998,0
flora speer,A Love Beyond Time (Love Spell),1999,14,3.5,2,1998,1
flora speer,Love Once &amp; Forever (Timeswept),1999,15,1.8,5,1999,0
flora speer,Timestruck (Romance of the Millennium),2000,16,0,2,1999,1
flora speer,A Time to Love Again (Timeswept),2000,17,0,1,2000,0
flora speer,A Passionate Magic (Heartspell),2001,18,4.5,4,2000,1
florence parry heide,Mystery of the Melting Snowman (Their a Spotlight Club Mystery),1974,2,0,2,1971,3
florence parry heide,Fables You Shouldn't Pay Any Attention To,1978,3,0,1,1974,4
florence parry heide,The Body in the Brillstone Garage (Pilot Books),1980,4,0,1,1978,2
florence parry heide,The Day of Ahmed's Secret,1990,5,7,1,1980,10
florence parry heide,That's What Friends Are for,2003,6,9.666666666666666,3,1990,13
fodor,Fodor's 2002 San Francisco (Fodor's San Francisco),2001,2,9.5,2,2001,0
forbes magazine  staff,ForbesÂ® Greatest Business Stories of All Time (Forbes),1997,2,0,1,1996,1
francelia butler,Childrens Literature,1972,2,0,1,1972,0
francelia butler,"Children's Literature, 1973",1975,3,0,1,1972,3
francelia butler,"Children's Literature, 1974",1975,4,0,1,1975,0
francelia butler,Children's Literature,1977,5,0,1,1975,2
francelia butler,Sharing Literature With Children,1978,6,0,1,1977,1
francelia butler,The Lucky Piece,1985,7,2.5,2,1978,7
frances burnett,A Little Princess,2000,2,4.5,4,1990,10
frances duncan,Finding Home,1982,2,0,1,1981,1
frances duncan,Toothpaste Genie,1991,3,0,1,1982,9
frances paige,Maeve's Daughter,1989,2,0,1,1987,2
frances sherwood,Vindication,1994,2,3.75,4,1993,1
frances sherwood,Green,1995,3,5,2,1994,1
frances sherwood,The Book of Splendor,2002,4,2,3,1995,7
frances sherwood,The Book of Splendor: A Novel,2003,5,3,2,2002,1
francesca marciano,Rules of the Wild,1999,2,5.357142857142857,14,1998,1
francesca marciano,Himmel Ã?Â¼ber Afrika.,2000,3,10,1,1999,1
francesca marciano,Casa Rossa : A Novel,2002,4,3,3,2000,2
francesca marciano,Casa Rossa,2003,5,0,2,2002,1
francesca mazzucato,Amore a Marsiglia (Farfalle),1999,2,1.25,4,1998,1
francesca mazzucato,Web CAM,2002,3,3,1,1999,3
francine prose,Bigfoot Dreams (Contemporary American Fiction),1987,2,3,2,1986,1
francine prose,Household Saints,1993,3,9,1,1987,6
francine prose,Hunters and Gatherers,1995,4,5,2,1993,2
francine prose,Hunters and Gatherers,1997,5,0,3,1995,2
francine prose,Guided Tours of Hell: Novellas,1998,6,0,2,1997,1
francine prose,The Peaceable Kingdom: Stories,1998,7,0,1,1998,0
francine prose,Bigfoot Dreams,1998,8,0,1,1998,0
francine prose,Blue Angel,2000,9,2.5714285714285716,14,1998,2
francine prose,Primitive People : A Novel,2001,10,7,1,2000,1
francine prose,Blue Angel : A Novel,2001,11,4,11,2001,0
francine prose,Guided Tours of Hell : Novellas,2002,12,8,1,2001,1
francine prose,The Lives of the Muses : Nine Women &amp; the Artists They Inspired,2002,13,0,1,2002,0
francine prose,After,2003,14,0,3,2002,1
francis crick,ASTONISHING HYPOTHESIS: THE SCIENTIFIC SEARCH FOR THE SOUL,1995,2,0,1,1990,5
francis jennings,The Ambiguous Iroquois Empire: The Covenant Chain Confederation of Indian Tribes With English Colonies from Its Beginnings to the Lancaster Treaty O,1990,2,0,1,1976,14
francis king,Act of Darkness,1983,2,4,1,1977,6
francis king,Voices in an Empty Room,1984,3,0,2,1983,1
francis king,The Firewalkers,1985,4,0,2,1984,1
francis king,Voices in an Empty Room,1986,5,0,1,1985,1
francis king,Danny Hill: Memoirs of a Prominent Gentleman,1987,6,6,1,1986,1
francis king,Nostradamus: Prophecies Fulfilled and Predictions for the Millennium and Beyond,1997,7,5,1,1987,10
francis king,The Prophecies of Nostradamus : and the World's Greatest Seers and Mystics,2001,8,4,1,1997,4
francis king,Prophecies Nostradamus And,2002,9,0,1,2001,1
francis macnutt,Praying for Your Unborn Child,1989,2,0,1,1974,15
francis macnutt,The Power to Heal,1992,3,10,1,1989,3
francis scott fitzgerald,El Ultimo Magnate,1995,2,5,1,1992,3
francis scott fitzgerald,El Crack-Up,1998,3,5,1,1995,3
francis scott fitzgerald,La SorciÃ?Â¨re rousse,2002,4,1.75,4,1998,4
francis scott fitzgerald,"Un diamant gros comme le Ritz, Ã?Â©dition bilingue (anglais/franÃ?Â§ais)",2003,5,8,1,2002,1
francisco de quevedo y. villegas,La Vida del Buscon,2003,2,0,1,1999,4
frank baldwin,Jake &amp; Mimi: A Novel,2002,2,1.3636363636363635,11,1998,4
frank baldwin,Jake &amp; Mimi: A Novel,2002,3,1.4,5,2002,0
frank bruni,"A Gospel of Shame: Children, Sexual Abuse, and the Catholic Church",2002,2,0,1,2002,0
frank bruni,Ambling into History : The Unlikely Odyssey of George W. Bush,2003,3,6,1,2002,1
frank c. smith,Thread of Evidence,2002,2,0,4,1986,16
frank de felitta,The Entity,1981,2,3,3,1980,1
frank de felitta,For Love of Audrey Rose,1982,3,0.631578947368421,19,1981,1
frank de felitta,"Audrey, Rose",1982,4,0,1,1982,0
frank de felitta,Sea Trial,1982,5,0,1,1982,0
frank de felitta,Audrey Rose,1984,6,3.6666666666666665,15,1982,2
frank de felitta,Golgotha Falls: An Assault on the Fourth Dimension,1985,7,0,1,1984,1
frank de felitta,Golgotha Falls: An Assault on the Fourth Dimension/#07959,1987,8,0,2,1985,2
frank de felitta,Funeral March,1991,9,8.5,2,1987,4
frank e peretti,Trapped at the bottom of the sea (A Cooper family adventure),1988,2,0,3,1985,3
frank g. slaughter,COUNTDOWN,1976,2,0,1,1975,1
frank g. slaughter,DEADLY LADY MADAGR,1976,3,0,1,1976,0
frank g. slaughter,SONG OF RUTH (Kangaroo Book),1977,4,3.5,2,1976,1
frank gill slaughter,In a Dark Garden,1976,2,0,1,1972,4
frank gill slaughter,PLAGUE SHIP,1977,3,0,2,1976,1
frank gill slaughter,Lorena,1977,4,7,1,1977,0
frank gill slaughter,Doctor's Daughters,1981,5,0,1,1977,4
frank gill slaughter,No Greater Love,1985,6,0,1,1981,4
frank harold trevor rhodes,Fossils: A Guide to Prehistoric Life,2000,2,6.333333333333333,3,1991,9
frank parrish,Fly in the Cobweb: A Dan Mallet Novel of Suspense,1986,2,0,1,1984,2
frank parrish,Fly in the Cobweb: A Dan Mallet Mystery,1988,3,0,1,1986,2
frank rose,The Joy of Spiritual Growth: Real Encounters,1999,2,10,1,1989,10
frank samuel caprio,Healing Yourself With Self-Hypnosis,1998,2,0,1,1983,15
frank simon,Trial by Fire,1999,2,4.5,2,1999,0
frank simon,The Raptor Virus: A Novel,2001,3,0,1,1999,2
frank yerby,Serpent and the Staff,1983,2,0,1,1980,3
frank yerby,Saracen Blade,1985,3,0,2,1983,2
franklin dixon,"Evil, Inc. (Hardy Boys Casefiles, No 2)",1987,2,0,2,1987,0
franklin dixon,"Dead on Target (Hardy Boys Casefiles, No 1)",1987,3,0,3,1987,0
franklin dixon,"WITNESS TO MURDER HARDY BOYS #20 (Hardy Boys Case Files, No 20)",1988,4,0,3,1987,1
franklin dixon,"STREET SPIES HARDY BOYS #21 (Hardy Boys Case Files, No 21)",1988,5,0,2,1988,0
franklin dixon,"DOUBLE EXPOSURE HARDY BOYS #22 (Hardy Boys Casefiles, No 22)",1988,6,0,1,1988,0
franklin dixon,"BLOOD MONEY HARDY BOYS CASEFILES #32 (Hardy Boys Casefiles, No 32)",1989,7,0,1,1988,1
franklin dixon,"HARDY BOYS CASEFILES #23: DISASTER FOR HIRE (Hardy Boys Casefiles, No 23)",1989,8,0,2,1989,0
franklin dixon,"Scene of the Crime (The Hardy Boys Casefiles, No. 24)",1989,9,0,1,1989,0
franklin dixon,"HARDY BOYS CASEFILES #44: CASTLE FEAR (Hardy Boys Casefiles, No 44)",1990,10,5,1,1989,1
franklin dixon,The Gross Ghost Mystery,1999,11,5,2,1990,9
franã?â§ois mauriac,La Fin de la nuit,1995,2,0,1,1989,6
franã§oise dorin,Les vendanges tardives,1997,2,0,1,1984,13
fred hoyle,On Stonehenge,1978,2,0,1,1975,3
fred hoyle,Fifth Planet,1979,3,0,1,1978,1
fred hoyle,The Black Cloud,1982,4,4,2,1979,3
fred hoyle,October the First Is Too Late,1985,5,0,1,1982,3
fred hoyle,The Black Cloud,1992,6,0,1,1985,7
fred leebron,In the Middle of All This,2002,2,0,1,1997,5
fred rogers,Mister Rogers Talks With Parents,1985,2,0,1,1983,2
fred rogers,If We Were All the Same (Mister Rogers Books),1988,3,10,1,1985,3
fred rogers,Going to the Hospital (First Experiences),1988,4,5,2,1988,0
fred rogers,When Monsters Seem Real: A Story from Mister Rogers' Neighborhood,1988,5,0,1,1988,0
fred rogers,Dear Mister Rogers: Does It Ever Rain in Your Neighborhood? : Letters to Mister Rogers,1996,6,10,1,1988,8
fred rogers,The New Baby: A Mister Rogers' First Experience Book (Paperstar),1996,7,6,1,1996,0
fred rogers,"Mister Rogers Playtime: Encourage Your Child to Create, Explore, and Pretend With Dozens of Nurturing and Easy-To-Do Activities",2001,8,10,1,1996,5
fred rogers,The World According to Mister Rogers,2003,9,4.294117647058823,17,2001,2
fred rosen,Lobster Boy,1995,2,0,3,1993,2
fred rosen,Blood Crimes,1996,3,1,5,1995,1
fred rosen,Gang Mom (St. Martin's True Crime Library),1998,4,1.5,2,1996,2
fred rosen,Deacon of Death,2000,5,0,2,1998,2
fred rosen,Body Dump,2002,6,8,1,2000,2
fred rosen,Flesh Collectors,2003,7,0,2,2002,1
fred rosen,The Evil Mother,2004,8,9,1,2003,1
fred rosen,Needle Work,2004,9,1.6666666666666667,3,2004,0
fred stenson,Teeth,1994,2,0,1,1990,4
fred stenson,The Trade,2000,3,8,2,1994,6
fred waitzkin,Searching for Bobby Fischer: The Father of a Prodigy Observes the World of Chess,1993,2,5,3,1988,5
fred waitzkin,Mortal Games: The Turbulent Genius of Garry Kasparov,1993,3,8,1,1993,0
fred wiersema,The New Market Leaders: Who's Winning and How in the Battle for Customers,2002,2,0,1,1996,6
freda bright,Infidelities,1987,2,1.6666666666666667,3,1986,1
freda bright,Singular Women,1988,3,0,5,1987,1
freda bright,Consuming Passions,1991,4,0,3,1988,3
frederic m. wheelock,Wheelock's Latin (Harpercollins College Outline),1995,2,3.3333333333333335,3,1992,3
frederic m. wheelock,"Wheelock's Latin, 6e",2000,3,0,2,1995,5
frederick downs,Killing Zone,1983,2,0,1,1983,0
frederick downs,Aftermath,1985,3,0,1,1983,2
frederick downs,The Killing Zone: My Life in the Vietnam War,1993,4,0,1,1985,8
frederick drimmer,"Captured by the Indians: 15 Firsthand Accounts, 1750-1870",1985,2,8,1,1975,10
frederick drimmer,"Body Snatchers, Stiffs and Other Ghoulish Delights",1987,3,0,1,1985,2
frederick drimmer,"Very Special People: The Struggles, Loves and Triumphs of Human Oddities",1991,4,7,1,1987,4
frederick drimmer,Born Different: Amazing Stories of Very Special People,1991,5,0,1,1991,0
frederick nolan,Jay J. Armes: Investigator,1977,2,0,1,1976,1
frederick reuss,Horace Afoot,1999,2,1.75,4,1997,2
freya littledale,Snow White,1980,2,0,1,1979,1
freya littledale,The Magic Fish,1987,3,0,2,1980,7
freya littledale,The Twelve Dancing Princesses: A Folk Tale from the Brothers Grimm (Easy to Read Folktale),1988,4,0,2,1987,1
freya littledale,Snow Child,1989,5,6,3,1988,1
freya littledale,"Stories of Ghosts, Witches, Demons",1992,6,0,2,1989,3
freya littledale,The Legend of Sleepy Hollow,1992,7,0,2,1992,0
friedrich wilhelm nietzsche,The Birth of Tragedy and the Case of Wagner,1967,2,0,1,1956,11
friedrich wilhelm nietzsche,The Gay Science: With a Prelude in Rhymes and an Appendix of Songs,1974,3,2.6666666666666665,3,1967,7
friedrich wilhelm nietzsche,A Nietzsche Reader (Penguin Classics),1978,4,5,5,1974,4
friedrich wilhelm nietzsche,Human All Too Human: A Book for Free Spirits,1989,5,0,1,1978,11
friedrich wilhelm nietzsche,Beyond Good and Evil: Prelude to a Philosophy of the Future (Penguin Classics),1990,6,2.6666666666666665,6,1989,1
friedrich wilhelm nietzsche,Basic Writings of Nietzsche (Modern Library),1992,7,6.5,2,1990,2
friedrich wilhelm nietzsche,Ecce Homo,1993,8,8,1,1992,1
friedrich wilhelm nietzsche,Asi Hablaba Zaratustra,1999,9,7,1,1993,6
friedrich wilhelm nietzsche,LA Gaya Ciencia,1999,10,0,1,1999,0
friedrich wilhelm nietzsche,Asi Hablo Zaratustra (Alba),1999,11,0,1,1999,0
friedrich wilhelm nietzsche,Ecce Homo: Como Se Llega a Ser Lo Que Se Es (Alba),1999,12,0,1,1999,0
friedrich wilhelm nietzsche,El Caminante y Su Sombra,1999,13,0,2,1999,0
friedrich wilhelm nietzsche,Sobre La Utilidad y Los Perjuicios de La Historia,2000,14,6,1,1999,1
friedrich wilhelm nietzsche,Aurora - El Anticristo,2001,15,0,1,2000,1
friedrich wilhelm nietzsche,El Crepusculo de Los Idolos,2002,16,0,1,2001,1
friedrich wilhelm nietzsche,El Ocaso de Los Idolos,2003,17,0,1,2002,1
fritz leiber,Conjure Wife,1977,2,9,1,1970,7
fritz leiber,Swords and Deviltry,1983,3,3.5,2,1977,6
fritz leiber,Changewar,1983,4,0,2,1983,0
fritz leiber,Swords Against Wizard,1983,5,0,1,1983,0
fritz leiber,Our Lady of Darkness,1984,6,5,1,1983,1
fritz leiber,Swords Against Death,1984,7,0,1,1984,0
fritz leiber,Conjure Wife (Science Fiction),1984,8,0,4,1984,0
fritz leiber,The Ghost Light: Masterworks of Science Fiction and Fantasy (Masterworks of Science Fiction and Fantasy),1984,9,0,1,1984,0
fritz leiber,The Ghost Light: Masterworks of Science Fiction and Fantasy,1984,10,6,1,1984,0
fritz leiber,Swords and Ice Magic,1984,11,4.5,2,1984,0
fritz leiber,SINFUL ONES,1986,12,0,1,1984,2
fritz leiber,The Knight and Knave of Swords,1990,13,1.5,4,1986,4
fritz leiber,You're All Alone,1990,14,0,1,1990,0
fritz leiber,The Ghost Light: Masterworks of Science Fiction and Fantasy,1991,15,0,1,1990,1
fritz leiber,Conjure Wife/Our Lady of Darkness (2 Books in One),1993,16,0,1,1991,2
fritz leiber,Fritz Leiber's Ill Met in Lankhmar (Lankhmar (Paperback)),1996,17,1.6666666666666667,3,1993,3
fritz leiber,The Dealings of Daniel Kesserich: A Study of the Mass-Insanity at Smithville,1998,18,6,1,1996,2
fritz leiber,Lean Times in Lankhmar (Lankhmar Series),1999,19,0,3,1998,1
fritz leiber,Dark Ladies,1999,20,10,1,1999,0
fritz leiber,Lankhmar: Tales of Fafhrd and the Gray Mouser (vol 1),2000,21,8,1,1999,1
fritz leiber,The Wanderer,2001,22,2.5,2,2000,1
fritz leiber,The Big Time,2001,23,0,1,2001,0
fritz leiber,Swords and Deviltry : Book 1 of the Adventures of Fafhrd and the Gray Mouser,2003,24,0,1,2001,2
frã?â©dã?â©ric beigbeder,Nouvelles sous ecstasy,2000,2,2,9,1997,3
frã?â©dã?â©ric beigbeder,MÃ?Â©moires d'un jeune homme dÃ?Â©rangÃ?Â©,2001,3,0,1,2000,1
frã?â©dã?â©ric beigbeder,14.99 Ã?Â?,2002,4,1.75,4,2001,1
fujihiko  kaneda,Beginner's Kana Workbook,1998,2,3.3333333333333335,3,1997,1
g. a. mckevett,Just Desserts (Savannah Reid Mysteries (Paperback)),1996,2,0,6,1995,1
g. a. mckevett,Bitter Sweets: A Savannah Reid Mystery,1997,3,0,6,1996,1
g. a. mckevett,Cooked Goose (Savannah Reid Mysteries (Paperback)),1998,4,0,1,1997,1
g. a. mckevett,Cooked Goose: A Savanna Reid Mystery (Savannah Reid Mysteries (Paperback)),1999,5,0.6666666666666666,9,1998,1
g. a. mckevett,Killer Calories (Savannah Reid Mysteries (Paperback)),2000,6,0,2,1999,1
g. a. mckevett,Just Desserts (Savannah Reid Mystery Series),2001,7,1.6666666666666667,3,2000,1
g. a. mckevett,Sour Grapes: A Savannah Reid Mystery (Savannah Reid Mysteries (Paperback)),2001,8,5,2,2001,0
g. a. mckevett,Sugar and Spite: A Savannah Reid Mystery (Savannah Reid Mysteries (Paperback)),2001,9,0.875,8,2001,0
g. a. mckevett,Peaches and Screams: A Savannah Reid Mystery (Savannah Reid Mysteries (Paperback)),2002,10,4.75,8,2001,1
g. a. mckevett,Cooked Goose (Savannah Reid Mysteries (Paperback)),2002,11,0.25,4,2002,0
g. a. mckevett,Peaches and Screams: A Savannah Reid Mystery (Savannah Reid Mysteries (Hardcover)),2002,12,9,1,2002,0
g. a. mckevett,Death by Chocolate: A Savannah Reid Mystery,2003,13,0.625,8,2002,1
g. a. mckevett,Death by Chocolate: A Savannah Reid Mystery (Savannah Reid Mysteries (Hardcover)),2003,14,2.6666666666666665,3,2003,0
g. a. mckevett,Cereal Killer: A Savannah Reid Mystery (Savannah Reid Mysteries (Hardcover)),2004,15,4.4,5,2003,1
"g. b., trudeau",Wouldn't a Gremlin Have Been More Sensible? (A Doonesbury book),1975,2,9,2,1974,1
"g. b., trudeau","""\Speaking of Inalienable Rights, Amy ..."""" (A Doonesbury book)""""""",1976,3,8,1,1975,1
"g. b., trudeau","""\Any Grooming Hints for Your Fans, Rollie?"""" (A Doonesbury book)""""""",1978,4,7.5,2,1976,2
"g. b., trudeau","""\What Do We Have for the Witnesses, Johnnie?"""" (A Doonesbury book)""""""",1980,5,0,2,1978,2
"g. b., trudeau","Guilty, Guilty, Guilty! (His A Doonesbury book)",1980,6,0,1,1980,0
"g. b., trudeau","Still a Few Bugs in the System, (His A Doonesbury book)",1980,7,8,1,1980,0
"g. b., trudeau",As the Kid Goes for Broke,1981,8,9,1,1980,1
g. tyler miller,Environmental Science: Working With the Earth (Wadsworth Biology Series),1994,2,0,1,1975,19
g. tyler miller,Sustaining the Earth With Infotrac: An Integrated Approach,2001,3,0,1,1994,7
gabriele von arnim,Jahrbuch Menschenrechte 2001.,2000,2,0,1,1992,8
gabrielle burton,Heartbreak Hotel (Contemporary American Fiction),1988,2,7,1,1986,2
gabrielle burton,Heartbreak Hotel,1999,3,7,1,1988,11
gabrielle euvino,The Complete Idiot's Guide to Learning Italian (2nd Edition),2001,2,0,1,1998,3
gabrielle lord,Jumbo,1986,2,2.5,2,1985,1
gabrielle lord,Bones,1995,3,2.6,5,1986,9
gabrielle lord,The sharp end,1998,4,0,1,1995,3
gaelle graham,Teach Yourself French: Complete Course (Teach Yourself Language Complete Courses),2003,2,8,1,1998,5
gail bell,The Poisoner : A Story of Family Secrets,2003,2,9,1,2002,1
gail giles,Dead Girls Don't Write Letters,2003,2,0,2,2002,1
gail giles,Dead Girls Don't Write Letters (Single Titles (Hardcover)),2003,3,8,2,2003,0
gail giles,Shattering Glass,2003,4,5,3,2003,0
gaius valerius catullus,The Complete Poetry of Catullus (Wisconsin Studies in Classics),2002,2,5,1,1990,12
gale pryor,"Nursing Mother, Working Mother: The Essential Guide for Breastfeeding and Staying Close to Your Baby After You Return to Work",1997,2,0,1,1997,0
gale pryor,Family Blessings for Special Moments Great and Small,2003,3,0,1,1997,6
gareth morgan,Images of Organization,1986,2,0,1,1986,0
gareth morgan,"Imaginization : New Mindsets for Seeing, Organizing, and Managing",1993,3,4,2,1986,7
gareth morgan,Images of Organization,1996,4,0,1,1993,3
garret keizer,No Place but Here: A Teacher's Vocation in a Rural Community,1989,2,0,1,1988,1
garret keizer,A Dresser of Sycamore Trees: The Finding of a Ministry,1991,3,8,1,1989,2
garret keizer,God of Beer,2003,4,0,1,1991,12
garrison keillor,Happy to be here,1983,2,2,7,1982,1
garrison keillor,Lake Wobegon Days,1985,3,2.68,75,1983,2
garrison keillor,Lake Wobegone Days,1986,4,2.3333333333333335,12,1985,1
garrison keillor,News from Lake Wobegon,1986,5,5,2,1986,0
garrison keillor,Lake Wobegon days,1986,6,1.91,100,1986,0
garrison keillor,"Prairie Home Companion 10th Anniversary: Show Recorded Live July 6-7, 1984/Audio Cassette/Pbn 905161984/Audio Cassette/Pbn 90516 (Prairie Home Companion)",1986,7,4,2,1986,0
garrison keillor,Lake Wobegon Days,1986,8,5,1,1986,0
garrison keillor,Happy to Be Here,1986,9,1.625,16,1986,0
garrison keillor,Lake Wobegon Days,1986,10,3.5,2,1986,0
garrison keillor,Leaving home,1987,11,8,1,1986,1
garrison keillor,Leaving Home/a Collection of Lake Wobegon Stories,1987,12,2.4166666666666665,48,1987,0
garrison keillor,Leaving Home,1987,13,8,1,1987,0
garrison keillor,Leaving Home,1988,14,2.65625,32,1987,1
garrison keillor,We Are Still Married: Stories and Letters,1989,15,1.4166666666666667,12,1988,1
garrison keillor,Leaving Home,1989,16,0,1,1989,0
garrison keillor,We Are Still Married: Stories and Letters (G.K. Hall Large Print Book Series),1990,17,0,1,1989,1
garrison keillor,We Are Still Married: Stories and Letters,1990,18,0.9411764705882353,17,1990,0
garrison keillor,Lake Wobegon Days,1990,19,1.475,40,1990,0
garrison keillor,Happy to Be Here,1990,20,0,4,1990,0
garrison keillor,Local Man Moves to the City,1991,21,9,1,1990,1
garrison keillor,Wlt: A Radio Romance,1991,22,1.9523809523809523,21,1991,0
garrison keillor,More News from Lake Wobegon (More News from Lake Wobegon),1991,23,8,1,1991,0
garrison keillor,Radio Romance,1992,24,0,1,1991,1
garrison keillor,Leaving Home,1992,25,2.5,10,1992,0
garrison keillor,Wlt: A Radio Romance,1992,26,3.6153846153846154,13,1992,0
garrison keillor,Radio Romance,1992,27,0,1,1992,0
garrison keillor,Radio Romance,1992,28,0,1,1992,0
garrison keillor,The Book of Guys: Stories,1993,29,3.533333333333333,15,1992,1
garrison keillor,The Book of Guys: Stories,1994,30,4,8,1993,1
garrison keillor,Lake Wobegon Days (Wisconsin),1995,31,2.5172413793103448,29,1994,1
garrison keillor,"Cat, You Better Come Home",1995,32,0,2,1995,0
garrison keillor,Wobegon Boy,1997,33,3.0869565217391304,23,1995,2
garrison keillor,Wobegon Boy,1998,34,2.8214285714285716,28,1997,1
garrison keillor,The Best American Short Stories 1998 (Serial),1998,35,0,2,1998,0
garrison keillor,The Best American Short Stories 1998 (Serial),1998,36,3,14,1998,0
garrison keillor,Me: by Jimmy (Big Boy) Valente,1999,37,2.2857142857142856,14,1998,1
garrison keillor,Pretty Good Joke Book: A Prairie Home Companion (Prairie Home Companion),2001,38,10,1,1999,2
garrison keillor,Lake Wobegon: Summer 1956,2001,39,4.12,25,2001,0
garrison keillor,Es kÃ?Â¶nnte schlimmer sein.,2002,40,0,1,2001,1
garrison keillor,Lake Wobegon Summer 1956,2002,41,5,1,2002,0
garrison keillor,Lake Wobegon Summer 1956,2002,42,2.7,10,2002,0
garrison keillor,Good Poems,2002,43,0,2,2002,0
garrison keillor,Good Poems,2002,44,9,1,2002,0
garrison keillor,Love Me,2003,45,3.8333333333333335,6,2002,1
garrison keillor,Good Poems,2003,46,2.7142857142857144,7,2003,0
garrison keillor,Homegrown Democrat: A FewPlain Thoughts From the Heart of America,2004,47,0,1,2003,1
garry jenkins,Harrison Ford: Imperfect Hero,1999,2,0,1,1998,1
garry jenkins,"""\Colonel"""" Cody and the Flying Cathedral: The Adventures of the Cowboy Who Conquered Britain's Skies""""""",2000,3,0,1,1999,1
garry jenkins,Harrison Ford: Imperfect Hero,2000,4,0,1,2000,0
garry trudeau,Check Your Egos at the Door (A Doonesbury book),1985,2,2.6666666666666665,3,1984,1
gary alexander,Deadly Drought,1991,2,0,1,1990,1
gary alexander,Kiet Goes West,1992,3,0,1,1991,1
gary alexander,Blood Sacrifice: A Mystery of the Yucatan,1993,4,0,2,1992,1
gary hardwick,Double Dead,1998,2,0,2,1997,1
gary hardwick,Supreme Justice: A Novel of Suspense,1999,3,2.5,2,1998,1
gary hardwick,Supreme Justice : A Novel Of Suspense,2001,4,3.5,2,1999,2
gary hardwick,Color of Justice,2002,5,0,1,2001,1
gary hardwick,The Color of Justice: A Novel of Suspense,2002,6,4.5,2,2002,0
gary j. oliver,How to Get It Right After You'Ve Gotten It Wrong,1995,2,0,1,1995,0
gary j. oliver,Raising Sons and Loving It!,2000,3,0,1,1995,5
gary jennings,Aztec,1981,2,0.6956521739130435,23,1980,1
gary jennings,The Journeyer (Journeyer CL),1984,3,5.666666666666667,3,1981,3
gary jennings,Azteca/Aztec,1985,4,2.3333333333333335,3,1984,1
gary jennings,The Journeyer,1985,5,0,1,1985,0
gary jennings,Spangle,1987,6,3.5,2,1985,2
gary jennings,Azteca,1991,7,0,1,1987,4
gary jennings,Journeyer,1991,8,2.8,5,1991,0
gary jennings,Raptor,1993,9,0,4,1991,2
gary jennings,Halcon (Spanish Language Eidtion),1995,10,6,1,1993,2
gary jennings,Lentejuelas,1995,11,0,1,1995,0
gary jennings,El Viajero,1995,12,8,1,1995,0
gary jennings,Azteca,1995,13,3.4,5,1995,0
gary jennings,Aztec Autumn,1997,14,2,3,1995,2
gary jennings,Journeyer,1997,15,0,1,1997,0
gary jennings,Aztec,1997,16,4.045454545454546,22,1997,0
gary jennings,Aztec Autumn,1998,17,1.1538461538461537,13,1997,1
gary jennings,The Center Ring: Spangle #2,1999,18,0,2,1998,1
gary jennings,Der Sohn des Azteken.,1999,19,8,1,1999,0
gary jennings,The Road Show: Spangle #1,1999,20,1.6666666666666667,6,1999,0
gary jennings,Marco Polo. Der Besessene I. Von Venedig zum Dach der Welt. Roman.,2000,21,0,2,1999,1
gary jennings,Aztec Blood (Aztec),2002,22,3.75,12,2000,2
gary jennings,Otono Azteca,2003,23,9,1,2002,1
gary jennings,Der Azteke,2003,24,0,1,2003,0
gary mccarthy,Wind River,1984,2,5,1,1983,1
gary mccarthy,Powder River,1985,3,0,2,1984,1
gary mccarthy,The Gringo Amigo (A Double D Western),1991,4,0,2,1985,6
gary mccarthy,The Horsemen (Horsemen),1992,5,8,1,1991,1
gary mccarthy,The Colorado (Rivers West : Book 3),1993,6,4.5,2,1992,1
gary mccarthy,The Comstock Camels (Double D Western),1993,7,1.6666666666666667,3,1993,0
gary mccarthy,Texas Mustangers (The Horseman Book No. 3),1993,8,0,1,1993,0
gary mccarthy,Yosemite/a Sweeping Epic Novel of the American Wilderness in the Bestselling Tradition of James Michener...: A Sweeping Epic Novel of the American Wil ... n the Bestselling Tradition of James Michener,1995,9,2,4,1993,2
gary mccarthy,Mesa Verde,1997,10,7,1,1995,2
gary mccarthy,The Gringo Amigo,1997,11,0,1,1997,0
gary mccarthy,Gunsmoke (Gunsmoke),1998,12,0,1,1997,1
gary mccarthy,Rivers West: The Cimarron River,1998,13,0,1,1998,0
gary mccarthy,Yellowstone,1998,14,0,3,1998,0
gary mccarthy,Powder River,1998,15,0,1,1998,0
gary mccarthy,Wind River,1998,16,0,1,1998,0
gary mccarthy,"Marshal Festus: A Novel (Gunsmoke, 3)",1999,17,0,1,1998,1
gary mccarthy,"Dead Man's Witness (Gunsmoke , No 2)",1999,18,0,2,1999,0
gary mccarthy,The Buffalo Hunters,2001,19,0,1,1999,2
gary provost,WITHOUT MERCY: OBSESSION AND MURDER UNDER THE INFLUENCE : WITHOUT MERCY: OBSESSION AND MURDER UNDER THE INFLUENCE,1990,2,0,1,1989,1
gary provost,Into Their Own Hands,1994,3,5,1,1990,4
gary provost,Baffled in Boston: A Mystery,1996,4,0,1,1994,2
gary s. aumiller,Red Flags!: How to Know When You're Dating a Loser,1999,2,8,1,1995,4
gavin de becker,The Gift of Fear : Survival Signals That Protect Us from Violence (Cassette),1997,2,0,1,1997,0
gavin de becker,The Gift of Fear,1998,3,3.4838709677419355,31,1997,1
gavin de becker,The Gift of Fear: Survival Signals That Protect Us from Violence,1999,4,2,3,1998,1
gavin de becker,Protecting the Gift: Keeping Children and Teenagers Safe (And Parents Sane),1999,5,4.1,10,1999,0
gavin de becker,Protecting the Gift: Keeping Children and Teenagers Safe (And Parents Sane),2000,6,8,1,1999,1
gavin menzies,1421: The Year China Discovered America,2003,2,2,10,2003,0
gavin menzies,1421. Als China die Welt entdeckte.,2003,3,0,2,2003,0
gavin menzies,1421 : The Year China Discovered America,2004,4,5.5,4,2003,1
gay cameron,Defendant (Legal Thriller) (Harlequin Intrigue),1996,2,0,3,1994,2
gayle callen,The Knight's Vow,1999,2,0,2,1999,0
gayle callen,My Lady's Guardian,2000,3,0,1,1999,1
gayle callen,His Betrothed,2001,4,3,3,2000,1
gayle callen,His Bride,2002,5,2.2857142857142856,7,2001,1
gayle callen,His Scandal (Avon Historical Romance),2002,6,2.5555555555555554,9,2002,0
gayle callen,No Ordinary Groom,2003,7,4.5,4,2002,1
gayle callen,The Beauty and the Spy,2004,8,8,1,2003,1
gayle kasper,"Here Comes the Bride (Loveswept, No 749)",1995,2,0,1,1994,1
gayle rosellini,Barriers to Intimacy: For People Torn by Addiction and Compulsive Behavior,1992,2,0,2,1988,4
gayle rosellini,Of Course You're Angry: A Guide to Dealing With the Emotions of Substance Abuse,1997,3,6,1,1992,5
geling yan,The Lost Daughter of Happiness: A Novel,2002,2,0,2,2001,1
gena hale,Dream Mountain,2001,2,2.142857142857143,7,2001,0
gena hale,Sun Valley,2002,3,8,1,2001,1
gene edwards,The Birth (Chronicles of the Door #2),1991,2,0,1,1980,11
gene edwards,A Tale of Three Kings: A Study of Brokenness,1992,3,0,1,1991,1
gene edwards,The Prisoner in the Third Cell,1992,4,0,1,1992,0
gene edwards,The Divine Romance,1993,5,5,2,1992,1
gene edwards,Overlooked Christianity,1997,6,0,1,1993,4
gene franks,The Art of Pencil Drawing (The Collector's Series/#CS01-5),1994,2,0,1,1990,4
gene k. garrison,Widowhood Happens,2002,2,10,1,2002,0
gene k. garrison,From Thunder to Breakfast,2002,3,9,1,2002,0
genevieve field,Nerve: Literate Smut,1998,2,2.5,4,1996,2
gentry lee,Rama Revealed: The Ultimate Encounter,1994,2,3.3333333333333335,3,1989,5
gentry lee,Bright Messengers (A Bantam Spectra Book),1995,3,0,1,1994,1
gentry lee,Bright Messengers (A Novel Set in the Rama Universe),1996,4,2.125,8,1995,1
gentry lee,Double Full Moon Night (A Bantam spectra book),1999,5,0,1,1996,3
gentry lee,Double Full Moon Night,2000,6,0,3,1999,1
geoff dyer,But Beautiful : A Book about Jazz,1997,2,8,1,1997,0
geoff dyer,Out of Sheer Rage : Wrestling With D.H. Lawrence,1998,3,3,2,1997,1
geoff dyer,Paris Trance: A Romance,2000,4,1.8,5,1998,2
geoff dyer,Yoga for People Who Can't Be Bothered to Do It,2003,5,1.5,4,2000,3
geoff dyer,Yoga for People Who Can't Be Bothered to Do It,2004,6,2,3,2003,1
geoffrey ashe,The Discovery of King Arthur,1987,2,3.5,2,1985,2
geoffrey ashe,Quest for Arthur's Britain,1987,3,0,1,1987,0
geoffrey ashe,The Landscape of King Arthur,1988,4,0,2,1987,1
geoffrey ashe,Merlin,2001,5,10,1,1988,13
geoffrey burnie,"Flowers (Little Guides (San Francisco, Calif.).)",2000,2,0,1,2000,0
geoffrey m. bellman,Your Signature Path: Gaining New Perspectives on Life and Work,1996,2,0,1,1992,4
geoffrey robertson,Crimes Against Humanity: The Struggle for Global Justice,2003,2,0,1,1999,4
georg wilhelm friedri hegel,Principios de La Filosofia del Derecho,2000,2,1,1,1988,12
george a. petrides,"Peterson Flash Guides, Trees: More Than 100 Species All the Trees Most Commonly Found Across the United States and Canada (Peterson Flashguides)",1996,2,8,1,1973,23
george a. petrides,Peterson First Guide to Trees (First Guide),1998,3,7,1,1996,2
george beal,"The Kingfisher Book of Words: A-Z Guide to Quotations, Proverbs, Origins, Usage, and Idioms",1992,2,8,1,1984,8
george berkeley,A Treatise Concerning the Principles of Human Knowledge (Oxford Philosophical Texts),1998,2,0,1,1986,12
george e. stanley,Who Invited Aliens to My Slumber Party (Scaredy Cats),1997,2,0,2,1996,1
george e. stanley,The Mystery of the Hairy Tomatoes,2001,3,0,1,1997,4
george e. stanley,The Cobweb Confession (Third-Grade Detectives),2001,4,8,1,2001,0
george fisher,There You Go Again: Editorial Cartoons of the Reagan Years,1987,2,10,1,1978,9
george harrar,The Spinning Man,2003,2,4.5,2,1990,13
george harrar,The Spinning Man,2004,3,0,3,2003,1
george harrison,BACKYARD BIRD-WATCHER,1988,2,0,1,1987,1
george harrison,"I, Me, Mine",2002,3,5,1,1988,14
george hayduke,Make 'Em Pay: Ultimate Revenge Techniques for the Master Trickster,1986,2,0,1,1983,3
george hayduke,Make My Day: Hayduke's Best Revenge Techniques for the Punks in Your Life,1988,3,7,1,1986,2
george hayduke,Advanced Backstabbing and Mudslinging Techniques,1991,4,7,1,1988,3
george hayduke,Righteous Revenge: Getting Down to Getting Even,1993,5,7,1,1991,2
george johnson,"Christmas Ornaments, Lights and Decorations: A Collector's Identification and Value Guide",1986,2,10,1,1983,3
george johnson,In the Palaces of Memory: How We Build the Worlds Inside Our Heads,1991,3,7,2,1986,5
george johnson,"Fire in the Mind: Science, Faith, and the Search for Order",1996,4,0,1,1991,5
george johnson,"Christmas Ornaments, Lights, and Decorations: Collector's Identification &amp; Value Guide (Christmas Ornaments III, Lights &amp; Decorations)",1996,5,10,1,1996,0
george johnson,"Christmas Ornaments, Lights and Decorations: Collector's Identification &amp; Value Guide (Christmas Ornaments II, Lights &amp; Decorations)",1996,6,10,1,1996,0
george johnson,Strange Beauty: Murray Gell-Mann and the Revolution in Twentieth-Century Physics,1999,7,0,1,1996,3
george johnson,A Shortcut Through Time : The Path to the Quantum Computer,2004,8,8,1,1999,5
george kennedy,Murder on Location,1983,2,0,1,1980,3
george kennedy,"Beyond the Inverted Pyramid: Effective Writing for Newspapers, Magazines and Specialized Publications",1992,3,5,1,1983,9
george lucas,Stars Wars,1977,2,1.4285714285714286,7,1976,1
george lucas,"Star Wars, Episode IV: A New Hope",1986,3,2.75,4,1977,9
george lucas,Willow: Based on the Motion Picture,1988,4,0,1,1986,2
george lucas,Star Wars: From the Adventures of Luke Skywalker,1989,5,0,3,1988,1
george lucas,Indiana Jones and the Last Crusade/Based on the Motion Picture Indiana Jones and the Last Crusade: Based on the Motion Picture Indiana Jones and the Last Crusade,1989,6,0,1,1989,0
george lucas,"Shadow Moon (Chronicles of the Shadow War, No 1)",1995,7,0.14285714285714285,7,1989,6
george lucas,"Star Wars, Episode IV: A New Hope",1995,8,0,1,1995,0
george lucas,"Shadow Moon (Chronicles of the Shadow War, Book 1)",1996,9,4.277777777777778,18,1995,1
george lucas,"The Star Wars Trilogy: Star Wars, the Empire Strikes Back, Return of the Jedi",1997,10,3.9166666666666665,12,1996,1
george lucas,Schattenmond.,1997,11,0,1,1997,0
george lucas,A New Hope (Star Wars),1998,12,0,1,1997,1
george lucas,"Shadow Dawn (Chronicles of the Shadow War, Book 2)",1998,13,3.4285714285714284,14,1998,0
george lucas,Star Wars. Krieg der Sterne.,1999,14,0,1,1998,1
george lucas,Star Wars Episode 1 : The Phantom Menace Movie Storybook,1999,15,0,3,1999,0
george lucas,The Star Wars Trilogy (Collected Novelizations),2002,16,0,1,1999,3
george moran,Fresh Eggs,1997,2,0,1,1975,22
george orwell,Animal Farm,1956,2,3.5,4,1956,0
george orwell,Animal Farm,1956,3,0,7,1956,0
george orwell,Animal Farm,1956,4,3.857142857142857,7,1956,0
george orwell,Keep the Aspidistra Flying (Harvest Book),1969,5,2.3333333333333335,6,1956,13
george orwell,Coming Up for Air (Harvest Book),1969,6,8,1,1969,0
george orwell,Homage to Catalonia (Harvest Book),1969,7,2.2857142857142856,14,1969,0
george orwell,A Clergyman's Daughter,1969,8,3.5,2,1969,0
george orwell,A Collection of Essays,1970,9,4,2,1969,1
george orwell,Down and Out in Paris and London,1972,10,4.5,18,1970,2
george orwell,New Windmills: Animal Farm (New Windmills),1972,11,7,1,1972,0
george orwell,The Road to Wigan Pier,1973,12,5.428571428571429,7,1972,1
george orwell,"Burmese Days: A Novel (Harbrace Paperbound Library, Hpl 62)",1974,13,4.5,6,1973,1
george orwell,Animal Farm. Kursmodell fÃ?Â¼r die Sekundarstufe II. SchÃ?Â¼lerarbeitsbuch. (Lernmaterialien),1976,14,0,1,1974,2
george orwell,George Orwell Complete &amp; Unabridged,1980,15,0,1,1976,4
george orwell,1984,1980,16,3.8095238095238093,42,1980,0
george orwell,1984 : a novel,1981,17,0,1,1980,1
george orwell,Animal Farm,1981,18,4,2,1981,0
george orwell,Nineteen Eighty-Four,1983,19,5,2,1981,2
george orwell,Rebelion en la Granja,1983,20,7,10,1983,0
george orwell,1984,1983,21,4.363636363636363,22,1983,0
george orwell,1984,1983,22,5,2,1983,0
george orwell,Nineteen Eighty-Four: The Facsimile of the Extant Manuscript,1984,23,9,1,1983,1
george orwell,1984 (Spanish Language Edition),1984,24,7.333333333333333,9,1984,0
george orwell,Nineteen Eighty-Four,1985,25,6,1,1984,1
george orwell,Nineteen Eighty-Four,1985,26,6.666666666666667,3,1985,0
george orwell,George Orwell's 1984,1985,27,0,1,1985,0
george orwell,Animal Farm,1986,28,3.3,10,1985,1
george orwell,Animal Farm,1990,29,4.5,4,1986,4
george orwell,1984,1990,30,4.614583333333333,192,1990,0
george orwell,Animal Farm,1990,31,3.515151515151515,33,1990,0
george orwell,1984,1991,32,0,1,1990,1
george orwell,1984 (Everyman's Library),1992,33,5,11,1991,1
george orwell,Animal Farm (Everyman's Library Series),1993,34,4.5,2,1992,1
george orwell,Nineteen Eighty Four,1993,35,8,1,1993,0
george orwell,1984.,1994,36,2.25,4,1993,1
george orwell,Animal Farm: A Fairy Story,1996,37,2.8,10,1994,2
george orwell,Nineteen Eighty-Four (Penguin Twentieth Century Classics S.),1996,38,7,1,1996,0
george orwell,Animal Farm: A Fairy Story,1996,39,10,2,1996,0
george orwell,Rebelion En La Granja,1996,40,8,1,1996,0
george orwell,1984,1997,41,3.6,5,1996,1
george orwell,Rebelion en la Granja,1998,42,4,1,1997,1
george orwell,1984,1998,43,10,2,1998,0
george orwell,Hommage Ã?Â  la Catalogne : 1936-1937,1999,44,5,2,1998,1
george orwell,1984 (Signet Classics (Paperback)),1999,45,4.25,8,1999,0
george orwell,Rebelion En LA Granja,1999,46,10,1,1999,0
george orwell,Animal Farm (Signet Classics (Paperback)),1999,47,10,1,1999,0
george orwell,Nineteen Eighty-four (Penguin Modern Classics),2000,48,0,1,1999,1
george orwell,LektÃ?Â¼rehilfen Nineteen Eighty- Four ( 1984). (Lernmaterialien),2000,49,8,1,2000,0
george orwell,LektÃ?Â¼rehilfen Animal Farm. Materialien. (Lernmaterialien),2000,50,4,2,2000,0
george orwell,Dans La Deche a Paris Et a Londres,2001,51,9,1,2000,1
george orwell,Farm der Tiere: Ein MÃ?Â¤rchen.,2002,52,2.888888888888889,9,2001,1
george orwell,1984.,2002,53,7.5,2,2002,0
george orwell,Animal Farm: A Fairy Story,2003,54,7,3,2002,1
george orwell,1984 ( Neunzehnhundertvierundachtzig). JubilÃ?Â¤umsausgabe. Roman.,2003,55,4,2,2003,0
george orwell,Nineteen Eighty-Four: A Novel,2003,56,4.923076923076923,13,2003,0
george orwell,Tage in Burma.,2003,57,0,2,2003,0
george orwell,Animal Farm,2004,58,4.695121951219512,164,2003,1
george orwell,Animal Farm,2004,59,10,1,2004,0
george s. morrison,"Education and Development of Infants, Toddlers, and Preschoolers",2003,2,7,1,2002,1
george s. morrison,"Early Childhood Education Today, Ninth Edition",2003,3,0,1,2003,0
george steiner,After Babel: Aspects of Language and Translation,1998,2,0,1,1981,17
george steiner,The Portage to San Cristobal of A. H. : A Novel (Phoenix Fiction Series),1999,3,0,1,1998,1
george steiner,Grammatik der SchÃ?Â¶pfung.,2001,4,0,1,1999,2
george washington,George Washington's Rules of Civility &amp; Decent Behaviour in Company and Conversation,1989,2,0,1,1981,8
george washington,George Washington's Rules of Civility and Decent Behavior in Company and Conversation (Little Books of Wisdom),1994,3,8,1,1989,5
george washington,George Washington : Writings (Library of America),1997,4,0,1,1994,3
george weigel,Witness to Hope: The Biography of Pope John Paul II,2001,2,0,1,1992,9
georges bordonove,Les rois qui ont fait la France : Henri IV,2002,2,0,1,1986,16
georges perec,Quel petit vÃ?Â©lo Ã?Â  guidon chromÃ?Â© au fond de la cour ?,1982,2,3,3,1978,4
georges perec,"Life, a User's Manual",1987,3,8,1,1982,5
georges perec,Life: A User's Manual,1988,4,1.4,5,1987,1
georges perec,W or the Memory of Childhood,1988,5,0,1,1988,0
georges perec,Homme Qui Dort,1990,6,4,7,1988,2
georges perec,Je suis nÃ© (La Librairie du XXe siÃ¨cle),1990,7,10,1,1990,0
georges perec,La Disparition (French Language Edition),1990,8,5.2,5,1990,0
georges perec,Les Choses,1992,9,4.4,5,1990,2
georges perec,"W, ou, Le souvenir d'enfance",1993,10,0,1,1992,1
georges perec,La Vida Instrucciones de USO,1995,11,4.75,4,1993,2
georges perec,Les Revenentes,1997,12,7,1,1995,2
georges perec,Je me souviens,1998,13,0,1,1997,1
georges perec,Ein Mann der schlÃ?Â¤ft.,2002,14,8,1,1998,4
georges perec,Things/a Man Asleep (Verba Mundi (Paperback)),2003,15,0,1,2002,1
georgia witkin,"Kidstress: What It Is, How It Feels, How to Help",1999,2,10,1,1997,2
georgia witkin,Stress Relief for Disasters Great and Small: What to Expect and What to Do from Day One to Year One and Beyond (Dr. Georgia Witkin Stress Books),2002,3,0,1,1999,3
gerald brittle,The Devil in Connecticut,1983,2,0,1,1980,3
gerald brittle,The Demonologist: The Extraordinary Career of Ed and Lorraine Warren,2002,3,3,2,1983,19
gerald gardner,Who's in Charge Here?: 1992,1992,2,0,1,1989,3
gerald hausman,Tunkashila: From the Birth of Turtle Island to the Blood of Wounded Knee,1993,2,0,1,1988,5
gerald hausman,Meditations With the Navajo: Prayer-Songs and Stories of Healing and Harmony,1998,3,9,1,1993,5
gerald hausman,The Mythology of Cats: Feline Legend and Lore Through the Ages,2000,4,1.5,4,1998,2
gerald hausman,The Mythology of Horses: Horse Legend and Lore Throughout the Ages,2003,5,0,1,2000,3
gerald hausman,Escape From Botany Bay,2003,6,0,1,2003,0
geraldine taylor,Bedtime (Ladybird Talkabout Books),1991,2,0,1,1977,14
gerard houarner,Road to Hell,2003,2,0,2,2001,2
gerd brantenberg,What Comes Naturally,1987,2,7,1,1985,2
gerd brantenberg,Egalia's Daughters: A Satire of the Sexes (Women in Translation),1995,3,6.5,4,1987,8
gerda weissmann klein,The Hours After,2000,2,0,1,1995,5
gerhart hauptmann,Vor Sonnenaufgang. Soziales Drama.,1994,2,6,1,1994,0
gerhart hauptmann,Vor Sonnenuntergang.,1994,3,0,1,1994,0
gerhart hauptmann,Die Ratten. Berliner TragikomÃ?Â¶die.,1994,4,0,1,1994,0
gerhart hauptmann,Rose Bernd.,1996,5,8,1,1994,2
gerhart hauptmann,Der Ketzer von Soana.,1996,6,4.333333333333333,3,1996,0
gerhart hauptmann,Die Weber. VollstÃ?Â¤ndiger Text des Schauspiels. Dokumentation.,1997,7,7,1,1996,1
gerhart hauptmann,BahnwÃ?Â¤rter Thiel. Textausgabe. (Lernmaterialien),2000,8,5,2,1997,3
gery greer,Max and Me and the Time Machine,1988,2,0,1,1983,5
gery greer,Max and Me and the Wild West,1989,3,0,1,1988,1
gery greer,This Island Isn't Big Enough for the Four of Us!,1989,4,0,1,1989,0
gery greer,Jason and the Escape from Bat Planet/a Trophy Chapter Book,1995,5,0,1,1989,6
gery greer,Billy the Ghost and Me (An I Can Read Chapter Book),1997,6,2.5,2,1995,2
gianni riotta,Prince of the Clouds,2000,2,6,1,1995,5
gianni riotta,Prince of the Clouds,2001,3,0,1,2000,1
gideon bosker,Patio Daddy-O a Recipe Journal,1997,2,7,1,1989,8
gideon bosker,The Beach: The History of Paradise on Earth,1999,3,8,1,1997,2
gideon bosker,Bowled Over: A Roll Down Memory Lane,2002,4,0,1,1999,3
gil courtemanche,A Sunday at the Pool in Kigali,2003,2,4,2,2000,3
gilbert morris,The Runaway,1987,2,0,1,1987,0
gilbert morris,The Last Confederate (House of Winslow),1990,3,0,1,1987,3
gilbert morris,The Final Curtain (Danielle Ross Mysteries),1991,4,0,1,1990,1
gilbert morris,"The Dixie Widow (House of Winslow, Bk. 9)",1991,5,0,1,1991,0
gilbert morris,Gate of His Enemies (Appomattox Saga #02),1992,6,0,1,1991,1
gilbert morris,"The End of Glory (The Price of the Liberty, No 4)",1993,7,0,2,1992,1
gilbert morris,"Beyond the River (The Far Fields Series, Book 1)",1993,8,10,1,1993,0
gilbert morris,Land of the Shadow (Appomattox Saga #04),1993,9,3.5,2,1993,0
gilbert morris,"All the Shining Young Men (The Price of Liberty, No 3)",1993,10,0,3,1993,0
gilbert morris,"The Valiant Gunman (House of Winslow, Book 14)",1993,11,0,1,1993,0
gilbert morris,"The Color of the Star (The Price of Liberty, 2)",1993,12,2,2,1993,0
gilbert morris,"The Sword of Truth (The Wakefield Dynasty, 1)",1994,13,0,2,1993,1
gilbert morris,The Winds of God (Wakefield Dynasty #2),1994,14,5,1,1994,0
gilbert morris,"A Silence in Heaven (Price of Liberty, No 5)",1994,15,0,1,1994,0
gilbert morris,Out of the Whirlwind (Appomattox Saga #05),1994,16,0,1,1994,0
gilbert morris,"The Jeweled Spur (House of Winslow, Book 16)",1994,17,0,1,1994,0
gilbert morris,Race With Death,1994,18,0,1,1994,0
gilbert morris,How to Write (And Sell) a Christian Novel: Proven and Practical Advice from a Best-Selling Author,1994,19,0,1,1994,0
gilbert morris,Shadow of His Wings (Appomattox Saga #06),1994,20,3.5,2,1994,0
gilbert morris,"The Yukon Queen (House of Winslow, No 17)",1995,21,0,2,1994,1
gilbert morris,Wall of Fire (Appomattox Saga #07),1995,22,7,1,1995,0
gilbert morris,The Rough Rider (House of Winslow),1995,23,0,1,1995,0
gilbert morris,"Winged Raiders of the Desert (Seven Sleepers, 5)",1995,24,6,1,1995,0
gilbert morris,"Empress of the Underworld (Seven Sleepers Series , No 6)",1996,25,0,2,1995,1
gilbert morris,"The Fields of Glory (Wakefield Dynasty/Gilbert Morris, Bk 4)",1996,26,0,1,1996,0
gilbert morris,Chariots in the Smoke (Appomattox Saga #09),1997,27,7,1,1996,1
gilbert morris,"Over the Misty Mountains (Spirit of Appalachia, No 1)",1997,28,0,1,1997,0
gilbert morris,"Escape from the Red Comet (The Daystar Voyages , No 3)",1998,29,0,1,1997,1
gilbert morris,Secret of the Planet Makon (Daystar Voyages),1998,30,0,1,1998,0
gilbert morris,"Wind from the Wilderness (Morris, Gilbert. Liberty Bell, Book 5.)",1998,31,0,1,1998,0
gilbert morris,Witness in Heaven (Appomattox Saga #10),1998,32,7,1,1998,0
gilbert morris,"Island of the Innocent (Cheney Duval, M.D., 7)",1998,33,3,3,1998,0
gilbert morris,"The White Hunter (House of Winslow, 22)",1999,34,0,1,1998,1
gilbert morris,Dixie and Perry (Dixie Morris Animal Adventures),1999,35,7,1,1999,0
gilbert morris,"The Flying Cavalier (The House of Winslow Series, No. 23)",1999,36,0,1,1999,0
gilbert morris,The Beginning Of Sorrows Enmeshed In Evil...how Long Before America Is No More?,1999,37,7,1,1999,0
gilbert morris,"Beneath the Mockingbird's Wings (Spirit of Appalachia, 4)",2000,38,0,1,1999,1
gilbert morris,One by One (A Dani Ross Mystery),2000,39,0,1,2000,0
gilbert morris,The Strange Creatures of Dr. Korbo (Seven Sleepers : The Lost Chronicles 3),2000,40,0,1,2000,0
gilbert morris,Jacob's Way,2001,41,0,2,2000,1
gilbert morris,"Where Two Seas Met (Cheney &amp; Shiloh: the Inheritance, 1)",2001,42,2,4,2001,0
gilbert morris,"The Fiery Ring (House of Winslow, 28)",2002,43,9,2,2001,1
gilbert morris,Jordan's Star,2002,44,0,2,2002,0
gilbert morris,"Heart of a Lion (Lions of Judah, 1)",2002,45,5,1,2002,0
gilbert morris,"Deep in the Heart: A Novel (Morris, Gilbert. Lone Star Series.)",2003,46,4.5,2,2002,1
gilbert morris,"The Silent Harp (Morris, Gilbert &amp; J. Landon Ferguson)",2004,47,8,1,2003,1
gilbert morris,"The Gates of Heaven (Morris, Gilbert &amp; J. Landon Ferguson)",2004,48,6,1,2004,0
gilbert sinoue,L'enfant de Bruges,2001,2,0,1,1998,3
gilbert sinoue,Die StraÃ?Â?e nach Isfahan. Historischer Roman.,2002,3,7,1,2001,1
gilbert sinoue,Der blaue Stein.,2002,4,0,4,2002,0
gilbert sinouã?â©,Des jours et des nuits ou Le Rire de Sara,2002,2,8,1,1997,5
gilbert sinouã?â©,L'Ambassadrice,2003,3,2.5,2,2002,1
giles tippette,Hard Rock,1991,2,0,1,1982,9
giles tippette,The HORSE THIEVES,1993,3,0,1,1991,2
giles tippette,WARNER &amp; LAURA : WARNER &amp; LAURA,1995,4,0,1,1993,2
giles tippette,Heaven's Gold,1996,5,0,1,1995,1
gill,Pockets Full of Joy,1988,2,0,1,1987,1
gill guile,Ring! Ring! (Sound Board Books ; No 3402),1993,2,4,1,1993,0
gill guile,Happy Birthday: My Big Little Fat Book,1994,3,0,1,1993,1
gill guile,Meow! Meow!,1995,4,0,1,1994,1
gill hale,How to Feng Shui Your Office (Practical Handbooks (Lorenz)),2001,2,0,1,2000,1
gill hale,The Practical Encycopedia of Feng Shui,2001,3,3.6,5,2001,0
gill hale,Practical Encyclopedia of Feng Shui: Practical Encyclopedia,2001,4,0,1,2001,0
gill hale,The Practical Encyclopedia of Feng Shui,2002,5,0,1,2001,1
gilles perrault,L'orchestre rouge,1989,2,0,2,1980,9
gilles perrault,The Red Orchestra (Witnesses to War),1989,3,9,1,1989,0
gilles perrault,Notre ami le roi,1992,4,0,1,1989,3
gilles perrault,Les jardins de l'Observatoire,1996,5,0,1,1992,4
ginny aiken,Candy Kiss (Homespun Series),1996,2,2.875,8,1993,3
ginny aiken,Crystal Memories,1997,3,0,1,1996,1
ginny aiken,A Bouquet of Love : An Arrangement of Four Beautiful Novellas About Friendship and Love (Heartquest),1999,4,3,2,1997,2
ginny aiken,Dream Vacation (HeartQuest Anthologies),2000,5,8,1,1999,1
ginny aiken,"Magnolia (Aiken, Ginny. Bellamy's Blossoms.)",2000,6,0,4,2000,0
ginny aiken,Lark (Bellamy's Blossoms #2),2000,7,2.3333333333333335,3,2000,0
ginny aiken,"Camellia (Heartquest Series : Bellamy's Blossoms Series, Book 3)",2001,8,0,1,2000,1
ginny aiken,"Light of My Heart (Aiken, Ginny. Silver Hills Trilogy.)",2004,9,0,1,2001,3
gioconda belli,The Inhabited Woman,1994,2,0,1,1991,3
gioconda belli,Zauber gegen die KÃ?Â¤lte. Erotische Gedichte. Spanisch - Deutsch.,1998,3,2.888888888888889,9,1994,4
gioconda belli,Waslala.,1999,4,5,1,1998,1
gioconda belli,Die Verteidigung des GlÃ?Â¼cks. Erinnerungen an Liebe und Krieg.,2001,5,9,1,1999,2
gioconda belli,The Country Under My Skin: A Memoir of Love and War,2002,6,4.666666666666667,3,2001,1
gioconda belli,The Country Under My Skin : A Memoir of Love and War,2003,7,0,1,2002,1
gita mehta,Raj,1990,2,3,3,1981,9
gita mehta,Le maharani,1990,3,3,1,1990,0
gita mehta,Raj: A Novel,1991,4,1.6666666666666667,9,1990,1
gita mehta,A River Sutra,1993,5,7.5,2,1991,2
gita mehta,Karma Cola: Marketing the Mystic East (Vintage International),1994,6,1.6666666666666667,3,1993,1
gita mehta,A River Sutra,1994,7,2.6363636363636362,11,1994,0
gita mehta,Snakes and Ladders: Glimpses of Modern India,1998,8,9,1,1994,4
gita mehta,Raj,1999,9,10,1,1998,1
giuseppe culicchia,Bla bla bla,1997,2,0,3,1995,2
giuseppe culicchia,Tutti Giu Per Terra,1997,3,9,1,1997,0
giuseppe culicchia,Mein Freund Anselm.,2002,4,0,1,1997,5
giuseppe pontiggia,Born Twice,2002,2,5,1,2000,2
gladys bagg taber,Still Cove Journal,1981,2,5,2,1974,7
gladys bagg taber,Stillmeadow Daybook,1986,3,5,2,1981,5
glenda sanders,"Island Nights (Harlequin Temptation, 300)",1990,2,0,4,1988,2
glenda sanders,"Babycakes (Harlequin Temptation, No 383)",1992,3,5,1,1990,2
glenda sanders,"Lovers' Secrets (Harlequin Temptation, No 454)",1993,4,0,3,1992,1
glenda sanders,More Than Kisses,1994,5,1.3333333333333333,3,1993,1
glenda sanders,"Not This Guy! (Grooms On The Run) (Harlequin Temptation, No 547)",1995,6,0,1,1994,1
glenda sanders,"Look Into My Eyes (Secret Fantasies) (Harlequin Temptation, No 566)",1995,7,0,3,1995,0
glenda sanders,Human Touch  (Rita Award),1996,8,2.5,4,1995,1
glenda sanders,Scandalous Suzanne,1996,9,0,1,1996,0
glenda sanders,"Midnight Train From Georgia (Harlequin Temptation, No 603)",1996,10,2,4,1996,0
glenn  liebman,"Football Shorts : 1,001 of the Game's Funniest One-Liners",1997,2,5,1,1995,2
glenn meade,Snow Wolf,1997,2,2.533333333333333,15,1996,1
glenn meade,Brandenburg,1997,3,8,1,1997,0
glenn meade,Brandenburg (Brandenburg),1998,4,2.5,6,1997,1
glenn meade,Operation Schneewolf.,1998,5,1.2857142857142858,7,1998,0
glenn meade,Unternehmen Brandenburg.,1999,6,0,2,1998,1
glenn meade,Sands of Sakkara,1999,7,1.75,4,1999,0
glenn meade,The Sands of Sakkara,2000,8,1.6428571428571428,14,1999,1
glenn meade,Mission Sphinx.,2000,9,3,2,2000,0
glenn meade,Die Achse des BÃ?Â¶sen.,2003,10,8.333333333333334,3,2000,3
gloria miklowitz,Carrie Loves Superman (Caprice Romance),1983,2,0,1,1981,2
gloria miklowitz,Did You Hear What Happened to Andrea (Laurel Leaf Books),1984,3,0,5,1983,1
gloria miklowitz,The War Between the Classes (Laurel-Leaf Contemporary Fiction),1986,4,8,1,1984,2
gloria miklowitz,After the Bomb: Week One (Point Paperback),1987,5,0,1,1986,1
gloria miklowitz,Desperate Pursuit,1992,6,0,1,1987,5
gloria skinner,Tender Trust (Heartfire Romance),1993,2,0,2,1990,3
gloria skurzynski,Lost in the Devil's Desert,1992,2,0,1,1984,8
gloria skurzynski,What Happened in Hamelin,1993,3,0,1,1992,1
gloria skurzynski,"Good-bye, Billy Radish (Aladdin Fiction)",1996,4,0,1,1993,3
gloria skurzynski,Mystery of the Vanishing Creatures (Mystery Solvers),1997,5,4,1,1996,1
gloria skurzynski,Mystery of the Spooky Shadow (Mystery Solvers Series),1997,6,1.6666666666666667,3,1997,0
gloria skurzynski,Mystery of the Fire in the Sky (Mystery Solvers),1997,7,0,1,1997,0
gloria skurzynski,"Wolfstalker - National Park'S Mysteries Series (Mysteries in Our National Parks, 1)",1998,8,5,1,1997,1
gloria skurzynski,Discover Mars,1998,9,0,1,1998,0
gloria skurzynski,Virtual War,1999,10,3,4,1998,1
gloria skurzynski,The Tempering (Golden Triangle Books),2000,11,0,1,1999,1
gloria skurzynski,Deadly Waters,2001,12,2.5,2,2000,1
gloria skurzynski,Wolfstalker (Mysteries in Our National Parks),2001,13,5,1,2001,0
gloria skurzynski,"Minstrel In The Tower (Stepping Stone,  paper)",2004,14,0,3,2001,3
gloria swanson,Swanson on Swanson,1984,2,0,1,1981,3
godfrey cave,Dictionary of Shrubs in Colour,1992,2,0,1,1992,0
godfrey cave,The Blitz,1994,3,7,1,1992,2
gooseberry patch,Family Favorites,1997,2,0,1,1997,0
gooseberry patch,"A Pinch Of This, A Dash Of That",1998,3,0,1,1997,1
gooseberry patch,Cozy Home Cookbook,1999,4,0,1,1998,1
gooseberry patch,Country Baking,2000,5,0,1,1999,1
gooseberry patch,Meals In Minutes,2002,6,0,1,2000,2
gordon davis,Liberation of Paris: The Sergeant,1981,2,0,1,1981,0
gordon inkeles,The New Massage: Total Body Conditioning for People Who Exercise,1980,2,9,2,1972,8
gordon inkeles,"NEW SENSUAL MASSAGE, THE",1992,3,5.6,5,1980,12
gordon prange,The Pearl Harbor Collection: At Dawn We Slept : Pearl Harbor : December 7 1941,2001,2,10,1,1985,16
gordon r dickson,Dragon and the George,1976,2,9,1,1976,0
gourmet magazine,The Best of Gourmet 2002: Featuring the Flavors of Paris,2002,2,10,1,2001,1
gourmet magazine,The Best of Gourmet : Featuring the Flavors of Rome (Best of Gourmet),2004,3,3.5,2,2002,2
grace fox anderson,The Hopeless Hen and Other Animal Tails (Animal tails series),1988,2,0,1,1979,9
grace fox anderson,Lamb on a Ledge &amp; Other Animal Tails (Animal Tails #8),1989,3,0,1,1988,1
grace livingston hill,Sunrise No. 25,1980,2,0,1,1980,0
grace livingston hill,Partners,1980,3,3,3,1980,0
grace livingston hill,The Finding of Jasper Hold,1980,4,0,1,1980,0
grace livingston hill,"Best Man, No. 7",1981,5,0,1,1980,1
grace livingston hill,Homing,1981,6,0,1,1981,0
grace livingston hill,"Brentwood, No. 18",1981,7,0,1,1981,0
grace livingston hill,The Substitute Guest,1982,8,0,1,1981,1
grace livingston hill,The man of the desert (Classic series),1982,9,8,1,1982,0
grace livingston hill,The girl from Montana (Classic series),1982,10,0,1,1982,0
grace livingston hill,"The Street of the City, No. 47",1983,11,0,1,1982,1
grace livingston hill,"Marcia Schuyler, No. 9 (Hill, Grace Livingston, Classic Series, 9.)",1983,12,8,1,1983,0
grace livingston hill,"Aunt Crete's Emancipation (Hill, Grace Livingston, Classic Series, 7.)",1984,13,8,1,1983,1
grace livingston hill,Marigold (Marigold),1984,14,0,1,1984,0
grace livingston hill,A Voice in the Wilderness (Classic Series),1984,15,8,1,1984,0
grace livingston hill,Angel of His Presence,1984,16,0,1,1984,0
grace livingston hill,"The Sound of the Trumpet (Hill, Grace Livingston, Classic Series, 14.)",1984,17,8,1,1984,0
grace livingston hill,The Witness (Classic Series),1984,18,0,1,1984,0
grace livingston hill,"Lo, Michael (Classic Series)",1984,19,0,1,1984,0
grace livingston hill,An Unwilling Guest,1985,20,9,1,1984,1
grace livingston hill,"Crimson Mountain (Grace Livingston Hill Series, No 15)",1985,21,8,1,1985,0
grace livingston hill,"The City of Fire (Grace Livingston Hill Series, No 76)",1986,22,0,1,1985,1
grace livingston hill,The Christmas Bride (Christmas Bride),1988,23,5,1,1986,2
grace livingston hill,Time of the Singing of Birds,1988,24,0,1,1988,0
grace livingston hill,Bright Arrows (Grace Livingston Hill),1989,25,3.5,2,1988,1
grace livingston hill,All Through the Night (Grace Livingston Hill #06),1989,26,0,1,1989,0
grace livingston hill,The Substitute Guest (Grace Livingston Hill #20),1989,27,0,1,1989,0
grace livingston hill,Found Treasure (Grace Livingston Hill #78),1989,28,8,1,1989,0
grace livingston hill,Where Two Ways Met (Grace Livingston Hill #01),1989,29,3,3,1989,0
grace livingston hill,Duskin (Grace Livingston Hill #81),1989,30,0,1,1989,0
grace livingston hill,Girl to Come Home to (Grace Livingston Hill),1989,31,0,1,1989,0
grace livingston hill,Phoebe Deane (Grace Livingston Hill),1990,32,9,1,1989,1
grace livingston hill,Stranger Within the Gates (The Grace Livingston Hill Series No. 14),1990,33,10,1,1990,0
grace livingston hill,"Miranda (Living Books, No 60)",1991,34,6,2,1990,1
grace livingston hill,"By Way of the Silverthorns (The Grace Livingston Hill Series, No 24)",1991,35,0,1,1991,0
grace livingston hill,Sunrise (Grace Livingston Hill),1992,36,2.25,4,1991,1
grace livingston hill,Patricia (Grace Livingston Hill #36),1992,37,0,1,1992,0
grace livingston hill,Crimson Roses (Grace Livingston Hill),1992,38,3.3333333333333335,3,1992,0
grace livingston hill,April Gold (Grace Livingston Hill #27),1992,39,8,1,1992,0
grace livingston hill,The Obsession of Victoria Gracen,1993,40,0,1,1992,1
grace livingston hill,Beauty for Ashes (Grace Livingston Hill #48),1993,41,7,1,1993,0
grace livingston hill,Ladybird (Grace Livingston Hill #55),1993,42,0,1,1993,0
grace livingston hill,"The City of Fire (Living Book Romance, No 76)",1994,43,0,1,1993,1
grace livingston hill,"The Strange Proposal (Grace Livingston Hill Series, No 31)",1994,44,0,2,1994,0
grace livingston hill,A Voice in the Wilderness (Grace Livingston Hill #91),1994,45,0,1,1994,0
grace livingston hill,Brentwood (Grace Livingston Hill #18),1995,46,0,1,1994,1
grace livingston hill,Marcia Schuyler/Pheobe Deane/Man of the Desert/Unto the End (Grace Livingston Hill Collection (Hardcover)),1995,47,9,1,1995,0
grace livingston hill,City of Fire Time of Singing Gold 3IN1 (Grace Livingston Hill Jumbo Reader),1995,48,2.6666666666666665,3,1995,0
grace livingston hill,Kerry (Grace Livingston Hill),1995,49,4,2,1995,0
grace livingston hill,White Orchids (Grace Livingston Hill #28),1995,50,8,1,1995,0
grace livingston hill,The Tryst (Grace Livingston Hill #40),1997,51,0,1,1995,2
grace livingston hill,Girl to Come Home to Best Man Ladybird (Grace Livingston Hill Jumbo Reader),1997,52,5,1,1997,0
grace livingston hill,Re-Creations (Grace Livingston Hill #89),1997,53,9,1,1997,0
grace livingston hill,"Grace Livingston Hill: Collection No. 4 (Livingston Hill Collection Series, No.4)",1999,54,0,1,1997,2
grace livingston hill,"Grace Livingston Hill: Collection No. 5 : Four Complete Novels (Grace Livingston Hill, 5)",2000,55,5,2,1999,1
graham edwards,Dragoncharm,1996,2,5,1,1992,4
graham lord,James Herriot: The Life of a Country Vet,1998,2,0,1,1997,1
graham lord,Sorry - We're Going to Have to Let You Go,2003,3,0,3,1998,5
graham lord,"Leider sehen wir uns gezwungen, Ihnen mitzuteilen...",2003,4,0,1,2003,0
graham tether,The Hair Book (Bright &amp; Early Book ; Be 24),1979,2,0,1,1979,0
greg king,The Mad King: The Life and Times of Ludwig II of Bavaria,1996,2,0,1,1994,2
greg palmer,Death : The Trip of a Lifetime,1998,2,9,1,1993,5
greg perry,C Programming in 12 Easy Lessons,1994,2,7,1,1993,1
greg perry,Sams Teach Yourself Visual Basic 6 in 21 Days,1998,3,0,1,1994,4
greg perry,C by Example (By Example),1999,4,0,1,1998,1
greg perry,Sams Teach Yourself Visual Basic 6 in 24 Hours (Sams Teach Yourself in 24 Hours),1999,5,7,1,1999,0
greg williams,Younger Than Springtime,1997,2,0,1,1982,15
gregg keizer,The Longest Night,2004,2,9,1,1996,8
gregg main,Every Trace,2000,2,0,2,1999,1
gregor gysi,"Ein Blick zurÃ?Â¼ck, ein Schritt nach vorn.",2002,2,3.5,2,1998,4
gregory frost,Tain,1986,2,2.5,2,1984,2
gregory frost,Lyrec,1986,3,0,3,1986,0
gregory frost,The Pure Cold Light,1993,4,2.3333333333333335,3,1986,7
gregory frost,Fitcher's Brides (Fairy Tales),2002,5,7.5,2,1993,9
gregory frost,Fitcher's Brides (Fairy Tales),2003,6,0,1,2002,1
gregory mcnamee,Gila: The Life and Death of an American River,1998,2,0,1,1997,1
gretchen sprague,Maquette For Murder (Worldwide Library Mysteries),2001,2,3.5,2,1999,2
gretchen sprague,Murder in a Heat Wave: A Martha Patterson Mystery,2003,3,8,1,2001,2
gretchen sprague,"Murder In A Heat Wave (Wwl Mystery, 489)",2004,4,0,3,2003,1
gretel ehrlich,Heart Mountain,1988,2,0,1,1986,2
gretel ehrlich,Heart Mountain,1989,3,7,1,1988,1
gretel ehrlich,Drinking Dry Clouds: Stories from Wyoming,1991,4,0,1,1989,2
gretel ehrlich,"Islands, the Universe, Home",1991,5,0,1,1991,0
gretel ehrlich,"Islands, the Universe, Home",1992,6,3.5,2,1991,1
gretel ehrlich,A Match to the Heart/One Woman's Story of Being Struck by Lightning,1995,7,4.571428571428571,7,1992,3
gretel ehrlich,This Cold Heaven : Seven Seasons in Greenland,2001,8,0,1,1995,6
groucho marx,Memoirs of a Mangy Lover,1989,2,7,1,1989,0
groucho marx,Groucho and Me (Classics of Modern American Humor Series),1991,3,0,1,1989,2
groucho marx,The Groucho Letters: Letters from and to Groucho Marx,1994,4,8,1,1991,3
groucho marx,Groucho and Me,1995,5,3.5,2,1994,1
groucho marx,Memoirs of a Mangy Lover,1997,6,7,1,1995,2
groucho marx,Groucho Y Yo,2002,7,0,2,1997,5
groucho marx,Groucho Y Yo,2002,8,7,1,2002,0
groucho marx,Memoirs of a Mangy Lover,2002,9,0,1,2002,0
groucho marx,Camas (Fbula),2002,10,5.5,2,2002,0
gudrun pausewang,Kinderbesuch. Roman.,1986,2,2.5,2,1981,5
gudrun pausewang,Fall-Out,1995,3,0,1,1986,9
gudrun pausewang,Einfach abhauen,1996,4,6,1,1995,1
gudrun pausewang,Die Wolke. ( Ab 13 J.).,1997,5,0,1,1996,1
gudrun pausewang,The Final Journey (Puffin Teenage Fiction),1998,6,10,1,1997,1
gudrun pausewang,Die letzten Kinder von Schewenborn. (Junge Erwachsene).,2003,7,2,1,1998,5
gurcharan das,India Unbound: From Independence to the Global Information Age,2002,2,6,2,2001,1
gus weill,The Cajuns : A Novel,2004,2,8,1,1993,11
gustav klimt,Gustav Klimt (Postcardbooks),1999,2,2.5,4,1994,5
gustav klimt,Klimt's Women,2000,3,9,1,1999,1
gustave flaubert,Madame Bovary,1964,2,0,1,1961,3
gustave flaubert,Madame Bovary,1964,3,0,3,1964,0
gustave flaubert,Madame Bovary: Backgrounds and Sources Essays in Criticism (Norton Critical Edition),1965,4,1.3333333333333333,6,1964,1
gustave flaubert,Dictionary of Accepted Ideas,1968,5,8,1,1965,3
gustave flaubert,Madame Bovary (Classics S.),1970,6,4.375,16,1968,2
gustave flaubert,Trois contes,1972,7,8.5,2,1970,2
gustave flaubert,Salambo,1977,8,0,1,1972,5
gustave flaubert,Madame Bovary (Bantam Classics),1982,9,2.9375,32,1977,5
gustave flaubert,Madame Bovary,1982,10,0.625,8,1982,0
gustave flaubert,Madame Bovary (Oxford Pocket Classics),1986,11,8,1,1982,4
gustave flaubert,Madame Bovary (Greenwich House Classics Library),1988,12,9,1,1986,2
gustave flaubert,Madame Bovary: Life in a Country Town (World's Classics),1989,13,4.125,8,1988,1
gustave flaubert,Three Tales,1989,14,0,1,1989,0
gustave flaubert,MADAME BOVARY  (French Language),1990,15,0,1,1989,1
gustave flaubert,Sentimental Education (Classics S.),1991,16,1,8,1990,1
gustave flaubert,Madame Bovary: Patterns of Provincial Life (Vintage Classics),1992,17,2.25,4,1991,1
gustave flaubert,L' Education Sentimentale,1992,18,0,1,1992,0
gustave flaubert,Madame Bovary: Provincial Lives (Penguin Classics),1993,19,5.6,10,1992,1
gustave flaubert,Madame Bovary: Patterns of Provincial Life (Everyman's Library Series),1993,20,4,2,1993,0
gustave flaubert,Madame Bovary,1994,21,1.2222222222222223,9,1993,1
gustave flaubert,Madame Bovary,1994,22,7,1,1994,0
gustave flaubert,Madame Bovary (Penguin Popular Classics),1995,23,2.923076923076923,13,1994,1
gustave flaubert,A Simple Heart (Penguin Classics 60s),1995,24,9,1,1995,0
gustave flaubert,A Simple Heart (New Directions Bibelot),1996,25,7,1,1995,1
gustave flaubert,Die Versuchung des heiligen Antonius.,1996,26,0,1,1996,0
gustave flaubert,Madame Bovary (Dover Thrift Editions),1996,27,0,8,1996,0
gustave flaubert,Madame Bovary.,1997,28,4,1,1996,1
gustave flaubert,Madame Bovary (New York Public Library Collector's Editions Series),1997,29,4,3,1997,0
gustave flaubert,Madame Bovary: Life in a Country Town (Oxford World's Classics),1998,30,0,1,1997,1
gustave flaubert,MADAME BOVARY,1998,31,2.7857142857142856,28,1998,0
gustave flaubert,Un Alma de Dios,1998,32,3.3333333333333335,3,1998,0
gustave flaubert,Salammbo (World Classics),1999,33,8,1,1998,1
gustave flaubert,Madame Bovary: Life in a Country Town (Oxford World's Classics (Hardcover)),1999,34,0,1,1999,0
gustave flaubert,Madame Bovary,2000,35,3.75,4,1999,1
gustave flaubert,Madame Bovary (World Classics),2000,36,0,1,2000,0
gustave flaubert,A Sentimental Education: The Story of a Young Man (Oxford World's Classics (Paperback)),2000,37,0,1,2000,0
gustave flaubert,Madame Bovary,2000,38,0,1,2000,0
gustave flaubert,L'Education Sentimenntale (World Classics),2000,39,4,1,2000,0
gustave flaubert,Leducation Sentimentale,2001,40,5,1,2000,1
gustave flaubert,Madame Bovary (Signet Classics (Paperback)),2001,41,3.2857142857142856,7,2001,0
gustave flaubert,Madame Bovary,2001,42,0,1,2001,0
gustave flaubert,SalambÃ³,2001,43,0,1,2001,0
gustave flaubert,Madame Bovary,2001,44,2.5,2,2001,0
gustave flaubert,Madame Bovary (Fabula),2002,45,4,2,2001,1
gustave flaubert,Madame Bovary (Wonders of the World S.),2002,46,3.5,2,2002,0
gustave flaubert,The Temptation of Saint Anthony (Modern Library Classics),2002,47,5,1,2002,0
gustave flaubert,Madame Bovary,2003,48,3.380952380952381,21,2002,1
gustave flaubert,Madame Bovary (ClÃ¡sicos selecciÃ³n series),2004,49,0,1,2003,1
gustavo adolfo bã©cquer,Rimas y leyendas (ClÃ¡sicos Fraile ; 3),1981,2,10,1,1979,2
gustavo adolfo bã©cquer,Leyendas (Literatura),1988,3,6.5,2,1981,7
guy carlier,Nouvelles chroniques tÃ?Â©lÃ?Â©,2003,2,3.3,10,2002,1
guy murchie,The Seven Mysteries of Life,1999,2,0,1,1981,18
gwendoline butler,Coffin on Murder Street,1992,2,0,2,1990,2
gwendoline butler,Coffin Underground,1992,3,0,7,1992,0
gwendoline butler,Coffin In The Museum Of Crime (A John Coffin Mystery),1993,4,0,5,1992,1
gwendoline butler,Cracking Open a Coffin,1993,5,0,1,1993,0
gwendoline butler,Coffin in Oxford,1998,6,0,2,1993,5
gwendoline butler,HeiÃ?Â?es Geld. Ein Fall fÃ?Â¼r John Coffin.,1999,7,2.5,2,1998,1
gwendoline butler,Grave Coffin (Worldwide Library Mysteries),2001,8,0,1,1999,2
gwendoline butler,Coffin Underground,2002,9,0,1,2001,1
gwendoline butler,Coffin Knows the Answer,2003,10,9,1,2002,1
gwendoline butler,Coffin's Ghost (Worldwide Library Mysteries),2003,11,1.6666666666666667,3,2003,0
gwendolyn brooks,Maud Martha,1992,2,5,1,1963,29
gwendolyn brooks,Selected Poems,1999,3,2.6666666666666665,3,1992,7
gwendolyn m. parker,Trespassing: My Sojourn in the Halls of Privilege,1999,2,0,1,1995,4
gwyneth cravens,Heart's Desire,1986,2,0,1,1978,8
gwynne dyer,Ignorant Armies : Sliding into War in Iraq,2003,2,5,2,1988,15
h. j. hutchins,The Prince of Tarn (Annick Young Novels),1997,2,0,1,1990,7
h. james harrington,"Business Process Improvement: The Breakthrough Strategy for Total Quality, Productivity, and Competitiveness",1991,2,10,1,1987,4
h. miller,Wuthering Heights (Classics Illustrated Study Guides Series),1997,2,0,1,1986,11
h.c. turk,Black Body,1991,2,4.4,5,1989,2
h.g. wells,New Windmills: The War of the Worlds (New Windmills),1968,2,0,1,1958,10
h.g. wells,Island of Dr.Moreau,1977,3,0,1,1968,9
h.g. wells,The Invisible Man (Bantam Classic),1983,4,3.25,8,1977,6
h.g. wells,The Island of Dr. Moreau (Bantam Classics),1994,5,3,5,1983,11
h.g. wells,The First Men in the Moon (Alien Voices),1998,6,2,3,1994,4
h.g. wells,The Invisible Man (Alien Voices),1998,7,3,6,1998,0
h.g. wells,Alien Voices: The First Men in the Moon,1999,8,8,1,1998,1
h.g. wells,Science Fiction Classics (8 Cassette Deluxe Edition),2001,9,0,1,1999,2
h.g. wells,The Island of Dr. Moreau (Modern Library Classics),2002,10,4,2,2001,1
h.g. wells,The Invisible Man : A Grotesque Romance (Modern Library Classics),2002,11,0,1,2002,0
h.g. wells,Tono-Bungay (Modern Library Classics),2003,12,0,2,2002,1
h.j. eysenck,Check Your Own I. Q. (Pelican S.),1969,2,0,2,1969,0
h.j. eysenck,Know Your Own Personality (Penguin Psychology),1991,3,5,1,1969,22
h.j. eysenck,Decline and Fall of the Freudian Empire (Penguin Psychology),1992,4,0,3,1991,1
hadley irwin,Kim/Kimi,1988,2,0,1,1980,8
hadley irwin,So Long at the Fair,1990,3,0,2,1988,2
hadley irwin,Jim-Dandy,1996,4,0,4,1990,6
hailey north,Pillow Talk (Avon Light Contemporary Romances),1999,2,2.1333333333333333,15,1998,1
hailey north,Perfect Match (Avon Light Contemporary Romances),2000,3,1.5,10,1999,1
hailey north,Dear Love Doctor (Avon Light Contemporary Romances),2001,4,1.8,10,2000,1
hailey north,Tangled Up in Love (Avon Light Contemporary Romances),2002,5,4.333333333333333,12,2001,1
hailey north,Opposites Attract (Avon Romance),2003,6,3.5555555555555554,18,2002,1
hailey north,Love: Undercover,2004,7,3.272727272727273,11,2003,1
haim g. ginott,Between Parent and Teenager,1988,2,0,5,1975,13
hal clement,Star Light,1978,2,0,1,1977,1
hal clement,Through the eye of a needle,1978,3,0,1,1978,0
hal clement,Close to Critical,1980,4,0,1,1978,2
hal clement,Still river,1987,5,0,2,1980,7
hal clement,Mission of Gravity,1989,6,5,1,1987,2
hal clement,Fossil: Isaac's Universe (DAW book collectors),1993,7,0,1,1989,4
hal clement,Half Life,2000,8,0,3,1993,7
hal clement,Noise,2003,9,9,1,2000,3
hal f. rosenbluth,The Customer Comes Second and Other Secrets of Exceptional Service,1994,2,2.5,2,1992,2
hal lindsey,"Late Great Planet Earth, The",1970,2,2.8333333333333335,6,1970,0
hal lindsey,Satan Is Alive and Well on Planet Earth,1972,3,0,1,1970,2
hal lindsey,Satan Is Alive and Well on Planet Earth,1972,4,0,1,1972,0
hal lindsey,"There's a new world coming;: \a prophetic odyssey.""""""""",1973,5,0,1,1972,1
hal lindsey,"There's a New World Coming: \A Prophetic Odyssey""""""""",1973,6,0,1,1973,0
hal lindsey,Liberation of Planet Earth,1975,7,0,2,1973,2
hal lindsey,The terminal generation,1977,8,0,2,1975,2
hal lindsey,Nineteen Eighty's: Countdown to Armageddon (178p),1981,9,0,1,1977,4
hal lindsey,Satan is Alive and Well on Planet Earth,1982,10,0,1,1981,1
hal lindsey,The Promise,1982,11,0,1,1982,0
hal lindsey,Rapture,1983,12,7,1,1982,1
hal lindsey,Late Great Planet Earth,1983,13,0,1,1983,0
hal lindsey,There's a New World Coming: An In-Depth Analysis of the Book of Revelation,1984,14,0,1,1983,1
hal lindsey,There's a New World Coming,1984,15,10,1,1984,0
hal lindsey,The Rapture: Truth or Consequences,1985,16,2,3,1984,1
hal lindsey,Combat Faith,1990,17,0,2,1985,5
hal lindsey,"Planet Earth: 2000 A.D., Will Mankind survive?",1994,18,0,1,1990,4
hal lindsey,The Final Battle,1995,19,0,3,1994,1
hal lindsey,Apocalypse Code,1997,20,0,1,1995,2
hal lindsey,Planet Earth: The Final Chapter,1999,21,9,1,1997,2
hal lindsey,Combat Faith: Unshakable Faith for Every Day,1999,22,0,1,1999,0
hal lindsey,The Everlasting Hatred: The Roots of Jihad,2002,23,0,1,1999,3
hal lindsey,Faith for Earth's Final Hour,2003,24,0,1,2002,1
hal schuster,The Making of Quantum Leap (Pioneer),1996,2,0,1,1995,1
halim,Vermillion eye: A chiller of a thriller that will shock you to the bone,2000,2,3.5,4,1997,3
halldor laxness,The Fish Can Sing,2001,2,7,1,1997,4
halldor laxness,Paradise Reclaimed,2002,3,0,1,2001,1
halldor laxness,The Fish Can Sing,2002,4,2.6666666666666665,3,2002,0
halldor laxness,Iceland's Bell,2003,5,0,1,2002,1
hamish macinnes,Climb to the Lost World,1976,2,8,1,1976,0
hanif kureishi,The Buddha of Suburbia,1990,2,2.5,2,1987,3
hanif kureishi,The Buddha of Suburbia,1991,3,2.0434782608695654,23,1990,1
hanif kureishi,Le Bouddha de banlieue,1993,4,3,1,1991,2
hanif kureishi,BLACK ALBUM,1995,5,0,1,1993,2
hanif kureishi,The BLACK ALBUM,1996,6,4.333333333333333,9,1995,1
hanif kureishi,The Black Album (Penguin/Faber Audiobooks),1997,7,4,1,1996,1
hanif kureishi,Intimacy,1998,8,4,2,1997,1
hanif kureishi,Black Album,1998,9,7,1,1998,0
hanif kureishi,Intimacy,1999,10,3.4285714285714284,7,1998,1
hanif kureishi,Der Buddha aus der Vorstadt. Roman.,1999,11,8,1,1999,0
hanif kureishi,INTIMACY : A NOVEL,1999,12,4.090909090909091,11,1999,0
hanif kureishi,Midnight All Day,1999,13,2.6666666666666665,3,1999,0
hanif kureishi,LOVE IN A BLUE TIME: SHORT STORIES,1999,14,0,1,1999,0
hanif kureishi,Midnight All Day,2000,15,1.6,5,1999,1
hanif kureishi,Buddha of Suburbia,2000,16,4.666666666666667,15,2000,0
hanif kureishi,Gabriel's Gift : A Novel,2001,17,3.25,4,2000,1
hanif kureishi,Black Album,2001,18,4,3,2001,0
hanif kureishi,Intimacy.,2001,19,9,1,2001,0
hanif kureishi,Intimacy and Midnight All Day: A Novel and Stories,2001,20,4.75,4,2001,0
hanif kureishi,"""\Intimacy"""" and Other Stories""""""",2001,21,0,1,2001,0
hanif kureishi,La Lune en plein jour,2002,22,8,1,2001,1
hanif kureishi,Gabriel's Gift: A Novel,2002,23,8,1,2002,0
hanif kureishi,El Regalo de Gabriel,2003,24,8,1,2002,1
hank herman,"One on One (Super Hoops , No 5)",1996,2,0,1,1996,0
hank herman,Crashing the Boards (Super Hoops No 1),1996,3,0,2,1996,0
hank herman,Monster Jam (BBC Radio Presents),1996,4,0,2,1996,0
hank herman,"Hang Time (Silver Hoops , No 9)",1997,5,0,1,1996,1
hank searls,Overboard: A novel,1977,2,3.5,2,1977,0
hank searls,Jaws 2: A Novel,1978,3,1.6428571428571428,14,1977,1
hank searls,Firewind,1982,4,4,2,1978,4
hank searls,Sounding,1982,5,0,1,1982,0
hank searls,Sounding,1982,6,2.5,4,1982,0
hank searls,Kataki: A Novel,1987,7,0,1,1982,5
hank searls,Kataki,1988,8,2.5,2,1987,1
hank searls,Kataki: A Novel of Revenge,2000,9,0,1,1988,12
hannah alexander,"Ozark Sunrise (Heartsong Presents, # 337)",1999,2,0,1,1998,1
hannah alexander,Sacred Trust (Er Trilogy),1999,3,0,1,1999,0
hannah alexander,Solemn Oath (Er Trilogy),2000,4,2.6666666666666665,3,1999,1
hannah alexander,Ozarks: The Hills Are Alive With Small Towns and Big Hearts Revealed in Four Complete Romances,2001,5,0,5,2000,1
hannah alexander,"Second Opinion (The Healing Touch, 1)",2002,6,6,3,2001,1
hannah alexander,Necessary Measures (Healing Touch),2002,7,0,1,2002,0
hannah alexander,The Crystal Cavern: Dont Get Caught Dead Underground,2003,8,0,1,2002,1
hannah alexander,Hideaway,2003,9,0.9,10,2003,0
hannah howell,Elfking's Lady,1993,2,0,1,1991,2
hannah howell,Wild Conquest,1993,3,5,1,1993,0
hannah howell,Only for You,1995,4,0,2,1993,2
hannah howell,Unconquered,1996,5,2,4,1995,1
hannah howell,Only for You,1996,6,0,2,1996,0
hannah howell,Wild Roses,1997,7,2.2857142857142856,7,1996,1
hannah howell,A Taste of Fire,1997,8,3.75,4,1997,0
hannah howell,Only for You,1998,9,6,1,1997,1
hannah howell,Highland Destiny,1998,10,1.75,8,1998,0
hannah howell,Scottish Magic,1998,11,1.6666666666666667,6,1998,0
hannah howell,Castle Magic (Zebra Historical Romance),1999,12,0,2,1998,1
hannah howell,Highland Promise,1999,13,1.75,8,1999,0
hannah howell,Highland Honor,1999,14,2.7142857142857144,7,1999,0
hannah howell,Highland Vow (Zebra Historical Romance),2000,15,3.3333333333333335,3,1999,1
hannah howell,A Stockingful of Joy (Zebra Historical Romance),2000,16,5,1,2000,0
hannah howell,A Taste of Fire (Zebra Historical Romance S.),2001,17,0,1,2000,1
hannah howell,Highland Knight (Zebra Historical Romance),2001,18,3.8,5,2001,0
hannah howell,Highland Bride (Zebra Historical Romance),2002,19,0,7,2001,1
hannah howell,Highland Hearts (Zebra Historical Romance),2002,20,1.5454545454545454,11,2002,0
hannah howell,His Immortal Embrace,2003,21,5.2,5,2002,1
hannah howell,Highland Angel (Zebra Historical Romance),2003,22,1.875,8,2003,0
hannah howell,Highland Groom (Zebra Historical Romance),2003,23,2,5,2003,0
hannah howell,Highland Warrior,2004,24,3.3333333333333335,3,2003,1
hannah howell,His Bonnie Bride,2004,25,1.6666666666666667,9,2004,0
hannah wakefield,The Price You Pay,1993,2,2,4,1990,3
hannah whitall smith,The Christian's Secret of a Happy Life,1989,2,0,1,1985,4
hannah whitall smith,God of All Comfort,1990,3,0,1,1989,1
hannah whitall smith,The God of All Comfort,1997,4,0,2,1990,7
hannah whitall smith,The Christian's Secret of a Happy Life (Value Book),1999,5,0,1,1997,2
hans bankl,Der Pathologe weiÃ?Â? alles...aber zu spÃ?Â¤t. Heitere und ernsthafte Geschichten aus der Medizin.,2003,2,0,1,1997,6
hans bankl,Im RÃ?Â¼cken steckt das Messer. Geschichten aus der Gerichtsmedizin.,2003,3,3,2,2003,0
hans hellmut kirst,Stunde der TotengrÃ¤ber: Roman,1988,2,0,1,1978,10
hans jã?â¼rgen press,The Black Hand Gang and the Mysterious House. ( Ab 12 J.). Englische Ausgabe mit vielen Vokabeln.,1997,2,10,1,1996,1
hans jã?â¼rgen press,The Black Hand Gang and the Treasure in Breezy Lake. ( Ab 12 J.). Englische Ausgabe mit vielen Vokabeln.,1997,3,10,1,1997,0
hans zinsser,"Rats, Lice, and History",1984,2,2.5,4,1940,44
hanswilhelm haefs,Neues nutzloses Wissen fÃ?Â¼r die Westentasche. Zunebst der Geschichte vom Vampir Graf Dracula,2001,2,3.5,2,1998,3
hanya bloom,"Vampire Cousins (Vic the Vampire, No 3)",1990,2,0,1,1990,0
hargreaves,Mr. Tickle (Mr. Men Books),1980,2,0,2,1980,0
hargreaves,Mr. Grumpy (Mr. Men Books),1980,3,0,1,1980,0
hargreaves,Little Miss Trouble (Little Miss Books),1981,4,0,1,1980,1
harold brighouse,Hobson's Choice,2000,2,0,1,1992,8
harold gould henderson,An Introduction to Haiku: An Anthology of Poems and Poets from Basho to Shiki,1983,2,4,2,1967,16
harold mcgee,The Curious Cook: More Kitchen Science and Lore,1992,2,3.3333333333333335,3,1984,8
harold myra,The Shining Face: A Novel,1993,2,0,1,1991,2
harold myra,Morning Child,1994,3,0,1,1993,1
harold s. kushner,When Bad Things Happen to Good People,1983,2,2.8125,32,1981,2
harold s. kushner,When Bad Things Happen to Good People,1985,3,3.727272727272727,11,1983,2
harold s. kushner,When All You've Ever Wanted Isn't Enough,1986,4,0,1,1985,1
harold s. kushner,When All You've Ever Wanted Isn't Enough,1987,5,4.5,8,1986,1
harold s. kushner,WHEN ALL YOU EVER WANTED ISN'T ENOUGH,1990,6,0,2,1987,3
harold s. kushner,To Life!: A Celebration of Jewish Being and Thinking,1993,7,10,2,1990,3
harold s. kushner,To Life! : A Celebration of Jewish Being and Thinking,1994,8,8,1,1993,1
harold s. kushner,How Good Do We Have to Be?: A New Understanding of Guilt and Forgiveness,1996,9,2.8181818181818183,11,1994,2
harold s. kushner,How Good Do We Have to Be? A New Understanding of Guilt and Forgiveness,1997,10,4,2,1996,1
harold s. kushner,Living a Life That Matters: Resolving the Conflict Between Conscience and Success,2001,11,6,6,1997,4
harold woods,South Central States: A First Book (First Book),1984,2,0,2,1982,2
harriet baskas,"Stuck At The Airport : The Very Best of Services, Dining, and Unexpected Attractions for Travelers",2001,2,3.2,5,1999,2
harriet grey,The Cable Guy,1996,2,0,2,1994,2
harriet k. feder,Mystery of the Kaifeng Scroll: A Vivi Hartman Adventure (A Vivi Hartman Adventure),1995,2,0,1,1992,3
harriet rochlin,On Her Way Home: a novel,2001,2,0,1,1998,3
harriet segal,Magnolia Dreams,1992,2,0,1,1985,7
harriet segal,The Skylark's Song: A Novel,1994,3,4.5,2,1992,2
harriet ziefert,Flip the switch (A Magic touch book),1984,2,4,1,1984,0
harriet ziefert,Nicky's Christmas Surprise (Lift the Flap Books),1985,3,0,1,1984,1
harriet ziefert,Nicky's Noisy Night (Lift the Flap Books),1986,4,0,2,1985,1
harriet ziefert,Sarah's Questions,1986,5,10,1,1986,0
harriet ziefert,"Lewis Said, Lewis Did! (Great Big Board Books)",1987,6,0,1,1986,1
harriet ziefert,Where's the Dog?,1987,7,7,1,1987,0
harriet ziefert,Mike and Tony: Best Friends,1987,8,0,1,1987,0
harriet ziefert,"So Hungry! (Step into Reading, Step 1, paper)",1987,9,0,1,1987,0
harriet ziefert,Where's the Guinea Pig?,1987,10,0,1,1987,0
harriet ziefert,"Thank You, Nicky! (A Lift-the-Flap Book)",1988,11,0,1,1987,1
harriet ziefert,A New Coat for Anna (Dragonfly Books),1988,12,5,1,1988,0
harriet ziefert,Here Comes a Bus/Lift-The-Flap (Picture Puffins),1988,13,0,2,1988,0
harriet ziefert,"Mommy, Where Are You? (Lift a Flap Book)",1989,14,0,1,1988,1
harriet ziefert,"Daddy, Can You Play With Me? (Picture Puffin S.)",1989,15,0,2,1989,0
harriet ziefert,Wish for a Fish (Pictureback Reader),1989,16,0,1,1989,0
harriet ziefert,In a Scary Old House (Life the Flap Book),1989,17,0,1,1989,0
harriet ziefert,The Best Castle Ever (Pictureback Readers),1989,18,0,2,1989,0
harriet ziefert,Can You Play? (Pictureback Readers),1989,19,0,1,1989,0
harriet ziefert,Hello Reading!: When the TV Broke,1989,20,5,1,1989,0
harriet ziefert,"Bears 1, 2, 3 (Pictureback Readers)",1989,21,0,1,1989,0
harriet ziefert,Wait for Us (Pictureback Readers),1989,22,0,1,1989,0
harriet ziefert,The Wheels on the Bus (Pictureback Readers),1990,23,0,1,1989,1
harriet ziefert,The Small Potatoes and the Magic Show,1990,24,0,1,1990,0
harriet ziefert,Where's Daddy's Car?,1992,25,0,1,1990,2
harriet ziefert,What's a Birthday? (A Lift-Flap Story),1993,26,0,1,1992,1
harriet ziefert,"Dark Night, Sleepy Night (Puffin Easy-to-Read, Level 1)",1993,27,0,1,1993,0
harriet ziefert,Let's Get a Pet,1993,28,0,1,1993,0
harriet ziefert,"The Three Little Pigs (Puffin Easy-to-Read, Level 2)",1995,29,2,2,1993,2
harriet ziefert,"The Gingerbread Boy (Puffin Easy-to-Read, Level 2)",1995,30,9,1,1995,0
harriet ziefert,Dr. Cat (Red),1995,31,0,2,1995,0
harriet ziefert,Benjy Bear's Christmas: A Happy Holiday Sticker Book,1996,32,0,1,1995,1
harriet ziefert,"Later, Rover (Puffin Easy-To-Read)",1996,33,9,1,1996,0
harriet ziefert,The Magic Porridge Pot: A Viking Easy-To-Read Classic (Viking Easy-to-Read. Level 1),1997,34,0,1,1996,1
harriet ziefert,"Bears Odd, Bears Even ( a Puffin Math Easy-to-Read)",1997,35,5,2,1997,0
harriet ziefert,"A Polar Bear Can Swim: What Animals Can and Cannot Do (Puffin Science Easy-to-Read, Level 2)",1998,36,0,1,1997,1
harriet ziefert,The Snow Child Level 2 (Puffin Easy-to-Read),2000,37,5,1,1998,2
harriet ziefert,Peephole Rhymes (Peephole Books),2001,38,5,1,2000,1
harrison evans salisbury,"Russia in revolution, 1900-1930",1978,2,9,1,1976,2
harrison evans salisbury,The 900 Days: The Siege of Leningrad (A Da Capo Paperback),1985,3,8,1,1978,7
harrison evans salisbury,Tiananmen Diary: Thirteen Days in June,1989,4,0,1,1985,4
harrison evans salisbury,Great Black Dragon Fire: A Chinese Inferno,1989,5,8,1,1989,0
harry allard,BUMPS IN THE NIGHT,1984,2,0,3,1984,0
harry blamires,The New Bloomsday Book: A Guide Through Ulysses,1996,2,10,1,1988,8
harry horse,The Last Castaways,2003,2,0,1,1999,4
"harry lee, jr. kraus",Fated Genes,1996,2,5.333333333333333,3,1994,2
harry mathews,The Human Country: New and Collected Stories (American Literature (Dalkey Archive)),2002,2,1.5,2,1988,14
harry middleton,"The Earth Is Enough: Growing Up in a World of Fly Fishing, Trout, &amp; Old Men",1996,2,9,1,1991,5
harry middleton,"On the Spine of Time: A Fly Fisher's Journey Among Mountain Streams, Trout, and People",1997,3,0,1,1996,1
harry ritter,"Washington's History: The People, Land, and Events of the Far Northwest (Westwinds Press Pocket Guides)",2003,2,7,1,1993,10
harry rowohlt,"Diana-TaschenbÃ?Â¼cher, Nr.66, Pooh's Corner",1999,2,8,1,1999,0
harry rowohlt,Pooh's Corner 2.,2002,3,9,1,1999,3
harvey b. mackay,"Sharkproof: Get the Job You Want, Keep the Job You Love... in Today's Frenzied Job Market",1994,2,0,1,1993,1
hayden carruth,"Scrambled Eggs &amp; Whiskey: Poems, 1991-1995",1996,2,9,1,1989,7
hayden curry,A Legal Guide for Lesbian and Gay Couples (9th),1996,2,10,1,1980,16
hayden curry,"A Legal Guide for Lesbian and Gay Couples (Legal Guide for Lesbian and Gay Couples, 11th ed)",2002,3,9,1,1996,6
hayden herrera,Frida Kahlo. Ein leidenschaftliches Leben.,2002,2,3.5,2,1991,11
hayden herrera,Frida Kahlo: The Paintings,2002,3,10,1,2002,0
hayden herrera,Frida : A Biography of Frida Kahlo,2002,4,2.5,12,2002,0
hayden herrera,Frida: Una Biografia de Frida Kahlo,2002,5,7,2,2002,0
heather allison,"Pulse Points (Harlequin Romance, No 3157)",1991,2,7.333333333333333,3,1990,1
heather allison,"Jack Of Hearts (Harlequin Romance, No 3218)",1992,3,1,5,1991,1
heather allison,"Haunted Spouse (Harlequin Romance, No 3284)",1993,4,0,3,1992,1
heather allison,"Ivy'S League (Harlequin Romance, No. 3269)",1993,5,8,1,1993,0
heather allison,"Santa Sleuth (Kids &amp; Kisses Christmas) (Harlequin Romance, No 3341)",1994,6,2.6666666666666665,3,1993,1
heather allison,"Counterfeit Cowgirl (Back To The Ranch) (Harlequin Romance, No 3309)",1994,7,1.8,5,1994,0
heather allison,"Undercover Lover (Sealed With A Kiss) (Harlequin Romance, No 3386)",1995,8,2.5,4,1994,1
heather allison,"Temporary Texan (Hitched!) (Harlequin Romance, No 3421)",1996,9,0,2,1995,1
heather allison,"Marry In Haste (Whirlwind Weddings) (Harlequin Romance, No 3487)",1997,10,0,3,1996,1
heather allison,"Marry Me (Simply The Best) (Harlequin Romance, No 3445)",1997,11,0,3,1997,0
heather amery,First Thousand Words a Picture Word Book,1981,2,0,1,1980,1
heather amery,Summer and Winter (What's the Difference),1986,3,8,1,1981,5
heather amery,Going to the Fair (Usborne Simple Readers),1987,4,0,1,1986,1
heather amery,Going Swimming (Usborne Simple Readers),1987,5,0,1,1987,0
heather amery,First Hundred Words in German (Usborne First Hundred Words (Hardcover)),1988,6,0,1,1987,1
heather amery,First Hundred Words (Usborne First Hundred Words (Hardcover)),1988,7,0,1,1988,0
heather amery,Looking At...Tyrannosaurus Rex: A Dinosaur from the Cretaceous Period (The New Dinosaur Collection),1993,8,0,2,1988,5
heather amery,Bugs (Discover Hidden Worlds),1994,9,10,1,1993,1
heather amery,Camping Out (Farmyard Tales Readers),1995,10,0,1,1994,1
heather amery,The Usborne First Thousand Words (Picture Word Books),1996,11,9,1,1995,1
heather amery,The Usborne First Thousand Words in Spanish: With Easy Pronunciation Guide (First Picture Book),1996,12,8,1,1996,0
heather amery,Alphabet Book (Farmyard Tales Books Series),1998,13,10,1,1996,2
heather amery,Where's Rusty (Farmyard Tales Flap Books Series),1998,14,8.5,2,1998,0
heather amery,The Christmas Story (Bible Tales Series),1998,15,9,1,1998,0
heather amery,The Story of Jesus (Usborne Bible Tales),1999,16,0,1,1998,1
heather amery,The Old Testament: The Usborne Children's Bible (The Usborne Children's Bible),1999,17,9,1,1999,0
heather amery,Usborne Greek Myths (Usborne Miniature Editions),2000,18,10,1,1999,1
heather amery,The Snow Storm (Usborne Farmyard Tales),2001,19,0,1,2000,1
heather amery,Pig gets lost,2001,20,0,1,2001,0
heather amery,First Hundred Words English (First Hundred Words),2002,21,0,2,2001,1
heather amery,Whats Happening on the Farm (What's Happening? Series),2002,22,3.5,2,2002,0
heather amery,Little Red Riding Hood (First Stories),2003,23,0,1,2002,1
heather conrad,Lights of Winter: Winter Celebrations Around the World,2001,2,5,2,1987,14
heather mcgowan,Schooling,2002,2,2.6666666666666665,3,2001,1
hedrick smith,Power Game: How Washington Works,1988,2,0,1,1977,11
hedrick smith,The Power Game: How Washington Works,1990,3,0,3,1988,2
hedrick smith,New Russians,1990,4,0,3,1990,0
hedrick smith,The New Russians: Updated to Include the Failed Coup,1991,5,0,1,1990,1
hedrick smith,New Russians,1991,6,0,1,1991,0
hedrick smith,The Russians,1993,7,0,4,1991,2
heidi julavits,The Mineral Palace,2001,2,3.4,10,2000,1
heidi julavits,The Mineral Palace,2001,3,0,2,2001,0
heidi julavits,The Effect of Living Backwards,2003,4,0,1,2001,2
heimito von doderer,Der Oger und andere Kurzgeschichten,1986,2,0,1,1985,1
heini gruffudd,Beginners Welsh (Beginner's (Foreign Language)),1998,2,10,1,1995,3
heini gruffudd,Welsh Learners Dictionary,1998,3,0,1,1998,0
heinrich dumoulin,Understanding Buddhism: Key Themes,1993,2,0,1,1989,4
heinrich robert zimmer,Myths and Symbols in Indian Art and Civilization,1972,2,7,1,1969,3
heinz insu fenkl,Memories of My Ghost Brother,1997,2,4,2,1996,1
helen archery,The Age of Elegance,1992,2,0,2,1992,0
helen archery,Duel of Hearts,1994,3,0,1,1992,2
helen brooks,"Spanish Affair (Latin Lovers) (Harlequin Presents, No. 2213)",2001,2,0,2,1993,8
helen brooks,"Mistress Contract (9 To 5) (Harlequin Presents, No 2153)",2001,3,0,3,2001,0
helen brooks,The Irresistible Tycoon  (9 To 5),2002,4,1.125,8,2001,1
helen brooks,Web of Darkness,2002,5,0,4,2002,0
helen brooks,Christmas At His Command  (Christmas),2002,6,1.75,4,2002,0
helen brooks,A WHIRLWIND MARRIAGE (Harlequin Presents),2002,7,1.4,5,2002,0
helen brooks,"The Greek Tycoon's Bride  (Greek Tycoons) (Harlequin Presents, 2255)",2002,8,2.5,6,2002,0
helen brooks,Lovers Not Friends,2003,9,0,1,2002,1
helen brooks,Sleeping Partners  (Nine to Five),2003,10,3.3333333333333335,3,2003,0
helen brooks,The Parisian Playboy   In Love With Her Boss,2003,11,4.8,5,2003,0
helen brooks,Deceitful Lover (Promotional Presents),2004,12,6,1,2003,1
helen cowcher,Antarctica (Sunburst Book),1991,2,0,1,1991,0
helen craig mccullough,Genji &amp; Heike: Selections from the Tale of Genji and the Tale of the Heike,1994,2,0,1,1991,3
helen dorman,"Okomi and the Tickling Game (The Okomi Series, 2)",2003,2,10,1,2003,0
helen dorman,"Okomi Plays in the Leaves (The Okomi Series, 3)",2003,3,10,2,2003,0
helen dorman,Okomi: Climbs a Tree (Okomi Series),2003,4,10,1,2003,0
helen e. fisher,"Anatomy of Love: The Natural History of Monogamy, Adultery, and Divorce",1992,2,0,2,1983,9
helen ellis,Eating The Cheshire Cat: A Novel,2001,2,2.5,2,2000,1
helen ellis,Eating The Cheshire Cat: A Novel,2001,3,3.4,15,2001,0
helen mccloy,Minotaur country: A novel of suspense,1975,2,0,1,1971,4
helen mcneil,Emily Dickinson (Virago pioneers),1986,2,0,1,1986,0
helen mcneil,Emily Dickinson (Everyman's Poetry Series),1997,3,4,2,1986,11
helen prejean,Dead Man Walking: An Eyewitness Account of the Death Penalty in the United States,1996,2,2.4054054054054053,37,1993,3
helen prejean,Dead Man Walking,1996,3,0,1,1996,0
helen r. myers,Confidentially Yours (Men at Work),1998,2,0,1,1993,5
helen r. myers,A Fine Arrangement (Family Continuity Program Series Number 5),1999,3,6,1,1998,1
helen r. myers,Whispers in the Wood,2000,4,0,1,1999,1
helen r. myers,No Sanctuary,2003,5,0,1,2000,3
helen simpson,Getting a Life,2002,2,3,5,2001,1
helen zahavi,BÃ?Â¶se MÃ?Â¤dchen lieben besser. Erotisches.,1997,2,0,1,1995,2
helen zahavi,Dirty Weekend,2000,3,10,1,1997,3
helene siegel,The Totally Mushroom Cookbook (Totally Cookbooks),1994,2,10,1,1994,0
helene siegel,The Totally Corn Cookbook (Totally Cookbooks),1994,3,8,3,1994,0
helene siegel,The Totally Chile Peppers Cookbook (Totally Cookbooks),1994,4,5.666666666666667,3,1994,0
helene siegel,The Totally Cookies Cookbook (Totally Cookbooks),1995,5,10,1,1994,1
helene siegel,Totally Muffins Cookbook (Totally Cookbooks),1995,6,9,2,1995,0
helene siegel,Totally Coffee Cookbook (Totally Cookbooks),1995,7,10,1,1995,0
helene siegel,The Totally Teatime Cookbook (Totally Cookbooks),1995,8,9,2,1995,0
helene siegel,The Totally Burgers Cookbook (Totally Cookbooks),1996,9,10,1,1995,1
helene siegel,The Totally Picnic Cookbook (Totally Cookbooks),1996,10,5,2,1996,0
helene siegel,The Totally Eggplant Cookbook (Totally Cookbooks),1996,11,10,1,1996,0
helene siegel,The Totally Pizza Cookbook (Totally Cookbooks),1996,12,10,1,1996,0
helene siegel,The Totally Pancakes &amp; Waffles Cookbook (Totally Cookbooks),1996,13,10,1,1996,0
helene siegel,The Totally Chocolate Cookbook (Totally Cookbooks),1996,14,6.333333333333333,3,1996,0
helene siegel,The Totally Camping Cookbook (Totally Cookbooks),1996,15,10,1,1996,0
helene siegel,The Totally Tomato Cookbook (Totally Cookbooks),1996,16,10,1,1996,0
helene siegel,The Totally Nuts Cookbook (Totally Cookbooks),1997,17,10,1,1996,1
helene siegel,Totally Bagel (Totally Cookbooks),1997,18,5,2,1997,0
helene siegel,Totally Crab (Totally Seafood Series),1997,19,10,1,1997,0
helene siegel,The Totally Eggs Cookbook (Totally Cookbooks),1997,20,2.5,4,1997,0
helene siegel,Totally Salmon (Totally Seafood Series),1997,21,10,1,1997,0
helene siegel,Totally Lobster (Totally Seafood Series),1997,22,10,1,1997,0
helene siegel,Totally Steak (Totally Cookbooks),1997,23,10,1,1997,0
helene siegel,Totally Shrimp (Totally Seafood Series),1997,24,10,1,1997,0
helene siegel,The Totally Apples Cookbook (Totally Cookbooks),1998,25,5,2,1997,1
helene siegel,The Totally Lemons Cookbook (Totally Cookbooks),1998,26,10,1,1998,0
helene siegel,The Totally Pies Cookbook (Totally Cookbooks),1998,27,10,1,1998,0
helene siegel,Totally Bread Cookbook (Totally Cookbooks),1999,28,10,1,1998,1
helene siegel,Totally Strawberries Cookbook (Totally Cookbooks Series),1999,29,10,1,1999,0
helene siegel,Totally Cheese Cookbook (Totally Cookbooks Series),1999,30,10,1,1999,0
helene siegel,The Totally Carrots Cookbook,2000,31,10,1,1999,1
helene siegel,The Totally Potato Cookbook (Totally Cookbooks),2000,32,10,1,2000,0
helge schneider,"Zieh dich aus, du alte Hippe.",1994,2,3.4285714285714284,7,1992,2
helge schneider,Das scharlachrote Kampfhuhn. Kommissar Schneiders letzter Fall.,1995,3,6,1,1994,1
helge schneider,Der MÃ?Â¶rder mit der Strumpfhose. Kommissar Schneider wird zum Elch.,1996,4,4,2,1995,1
helge schneider,Der Scheich mit der Hundehaarallergie. Kommissar Schneider flippt extrem aus.,2001,5,3.5,2,1996,5
helmut krausser,Der grosse Bagarozy: Roman,1997,2,9,1,1992,5
helmut krausser,Thanatos.,1998,3,0,1,1997,1
helmut krausser,Der groÃ?Â?e Bagarozy.,1999,4,8,1,1998,1
helmut krausser,Schmerznovelle.,2002,5,3.25,4,1999,3
henny youngman,"Take My Life, Please!",1991,2,0,3,1990,1
henri cartier-bresson,Henri Cartier-Bresson : A Propos de Paris,1998,2,0,1,1985,13
henri charriere,Papillon,2001,2,4.384615384615385,13,1973,28
henrietta c. mears,What the Bible Is All About: Niv,1993,2,10,1,1983,10
henrietta c. mears,What the Bible Is All About,1997,3,8,1,1993,4
henry adams,Democracy,1983,2,0,1,1964,19
henry adams,The Education of Henry Adams (Modern Library Series),1996,3,0,2,1983,13
henry adams,The Education of Henry Adams,1999,4,2.5,2,1996,3
henry adams,The Education of Henry Adams (Oxford World's Classics),1999,5,2.5,2,1999,0
henry adams,The Education of Henry Adams: An Autobiography,2000,6,9,1,1999,1
henry berry,This Is No Drill: Living Memories of the Attack on Pearl Harbor,2001,2,9,1,1987,14
henry beston,The outermost house: A year of life on the Great Beach of Cape Cod,1976,2,0,3,1962,14
henry beston,Outermost House,1980,3,0,3,1976,4
henry beston,The Outermost House: A Year of Life on the Great Beach of Cape Cod,1985,4,9,1,1980,5
henry beston,The Outermost House: A Year of Life on the Great Beach of Cape Cod,1992,5,2.142857142857143,7,1985,7
henry bromell,Little America,2002,2,2.5,4,2001,1
henry kissinger,DIPLOMACY,1994,2,5.666666666666667,3,1982,12
henry kissinger,Diplomacy,1995,3,8.25,4,1994,1
henry kissinger,Does America Need a Foreign Policy? : Toward a Diplomacy for the 21st Century,2002,4,5,1,1995,7
henry m. morris,Genesis Record: A Scientific and Devotional Commentary on the Book of Beginnings,1981,2,4,6,1974,7
henry m. morris,"The Remarkable Journey of Jonah: A Scholarly, Conservative Study of His Amazing Record",2003,3,0,1,1981,22
henry morton robinson,Der Kardinal.,1995,2,4.666666666666667,3,1978,17
henry steele commager,Pocket History of the United States,1992,2,0,1,1986,6
henry steele commager,Why the North Won the Civil War,1996,3,10,1,1992,4
henry van dyke,Story of the Other Wise Man,1983,2,8,1,1972,11
henry van dyke,The Story of the Other Wise Man,1990,3,3.3333333333333335,3,1983,7
henry van dyke,The Story of the Other Wise Man,1996,4,8,1,1990,6
henry van dyke,The Blue Flower,2004,5,6,1,1996,8
herbert zim,Insects (Golden Guide),1999,2,10,1,1964,35
herman brusselmans,Doch verder geen paniek: Doorgrondelijke wijsheden van Herman Brusselmans,1997,2,5,1,1986,11
herman brusselmans,Het einde van mensen in 1967,1999,3,9,1,1997,2
herman brusselmans,Uitgeverij Guggenheimer,1999,4,8,1,1999,0
herman brusselmans,Vergeef mij de liefde,2000,5,7,1,1999,1
herman brusselmans,De kus in de nacht,2002,6,8,1,2000,2
hermann broch,Death of Virgil,1995,2,0,1,1988,7
heron carvic,Miss Seeton Sings,1989,2,2,3,1988,1
heron carvic,Picture Miss Seeton,1989,3,0,7,1989,0
heron carvic,Witch Miss Seeton,1991,4,0,5,1989,2
heron carvic,Miss Seeton Draws the Line,1991,5,2.2,5,1991,0
heron marquez,Latin Sensations (A&amp;E Biography),2001,2,5,1,1998,3
hester kaplan,The Edge of Marriage: Stories,2001,2,0,1,2001,0
hester kaplan,Kinship Theory: A Novel,2002,3,0,1,2001,1
hidenori kusaka,"Pokemon Adventures: Yellow Caballero, The Ice Cage",2001,2,0,2,2000,1
hilary mandleberg,Essence of Stone,2000,2,0,1,2000,0
hilary mandleberg,Essence of White,2000,3,0,2,2000,0
hilary mckay,Vier verrÃ?Â¼ckte Schwestern und ein Freund in Afrika. ( Ab 10 J.).,1995,2,0,1,1994,1
hilary mckay,DOLPHIN LUCK,1999,3,4,2,1995,4
hilary mckay,Saffy's Angel,2002,4,3.5,2,1999,3
hilary mckay,Saffy's Angel,2003,5,6,3,2002,1
hilbert schenck,Chronosequence,1990,2,9,1,1988,2
hilda boswell,Hilda Boswell's Blue Treasury,1988,2,0,1,1983,5
hildebrand,Dutch at Your Fingertips (Hippocrene Handy Dictionaries),1991,2,0,1,1988,3
hildegard toma,Das kleine Duftzauberbuch. Von der Welt der DÃ?Â¼fte und Aromen.,2002,2,4,2,2002,0
hiro mashima,Rave Master #2,2002,2,6,1,2002,0
holly beth walker,Meg and the Mystery in Williamsburg,1978,2,3.5,2,1978,0
holly chamberlin,The Summer of Us,2004,2,8,1,2002,2
holly chamberlin,Living Single,2004,3,8,1,2004,0
honorâ© de balzac,Lys Dans LA VallÂ©E,2000,2,0,1,1972,28
honorã?â© de balzac,La Peau de chagrin,1974,2,8,1,1972,2
honorã?â© de balzac,Illusions perdues,1975,3,0,1,1974,1
honorã?â© de balzac,La Maison du chat-qui-pelote et autres ScÃ?Â¨nes de la vie privÃ?Â©e,1983,4,0,1,1975,8
honorã?â© de balzac,Splendeurs et MisÃ?Â¨res des courtisanes,1988,5,0,2,1983,5
honorã?â© de balzac,"Gobseck, une double famille",1993,6,0,1,1988,5
honorã?â© de balzac,Une fille d'Eve,1993,7,0,1,1993,0
honorã?â© de balzac,Le PÃ?Â¨re Goriot,1997,8,0,1,1993,4
honorã?â© de balzac,La Femme de trente ans,1999,9,3.5,2,1997,2
honorã?â© de balzac,Le PÃ?Â¨re Goriot,1999,10,4,2,1999,0
hope c. clarke,Pent Up Passion,2001,2,10,1,1999,2
horst rechelbacher,Aveda Rituals : A Daily Guide to Natural Health and Beauty,1999,2,8.666666666666666,3,1989,10
howard blum,I PLEDGE ALLEGIANCE : I PLEDGE ALLEGIANCE,1989,2,0,1,1978,11
howard blum,Out There: The Government's Secret Quest for Extraterrestrials,1992,3,0,1,1989,3
howard blum,Gangland: How the FBI Broke the Mob,1993,4,0,1,1992,1
howard blum,Gangland : How the FBI Broke the Mob,1995,5,0,2,1993,2
howard blum,The GOLD OF EXODUS,1998,6,2.8333333333333335,6,1995,3
howard blum,The GOLD OF EXODUS CASSETTE : The Discovery of the Real Mount Sinai,1998,7,0,1,1998,0
howard blum,The Gold of Exodus,1999,8,4,4,1998,1
howard blum,"The Brigade : An Epic Story of Vengeance, Salvation, and World War II",2001,9,9,1,1999,2
howard fast,The Establishment,1979,2,0,3,1977,2
howard fast,Time and the Riddle: Thirty-One Zen Stories,1980,3,2.5,2,1979,1
howard fast,Second Generation,1982,4,0,4,1980,2
howard fast,Second Generation,1982,5,0.7142857142857143,14,1982,0
howard fast,Max,1982,6,2,5,1982,0
howard fast,Legacy,1982,7,0,5,1982,0
howard fast,April Morning,1983,8,2.3333333333333335,12,1982,1
howard fast,April Morning,1983,9,5.333333333333333,3,1983,0
howard fast,Spartacus,1983,10,0,1,1983,0
howard fast,The Outsider,1984,11,1.5,4,1983,1
howard fast,The Immigrant's Daughter,1985,12,5,1,1984,1
howard fast,The Outsider,1985,13,0.25,12,1985,0
howard fast,The Immigrants,1985,14,0.29411764705882354,17,1985,0
howard fast,Immigrant's Daughter,1987,15,0.8,10,1985,2
howard fast,The Dinner Party,1987,16,0,4,1987,0
howard fast,The Jews: Story of a People,1988,17,0,1,1987,1
howard fast,The Pledge,1989,18,0.7777777777777778,9,1988,1
howard fast,The Confession of Joe Cullen (G K Hall Large Print Book Series),1990,19,0.5,2,1989,1
howard fast,Max,1990,20,0.7272727272727273,11,1990,0
howard fast,Confession of Joe Cullen,1990,21,0.75,8,1990,0
howard fast,The Dinner Party,1991,22,0.6,10,1990,1
howard fast,Sylvia: A Novel,1992,23,0,1,1991,1
howard fast,The Trial of Abigail Goodman,1993,24,6,1,1992,1
howard fast,The Hessian,1997,25,5,7,1993,4
howard fast,An Independent Woman,1997,26,0,3,1997,0
howard fast,"Compromiso, El",1998,27,2.5,2,1997,1
howard fast,Redemption,1999,28,0,2,1998,1
howard fast,An Independent Woman,1999,29,0.5294117647058824,17,1999,0
howard fast,Greenwich,2000,30,8,1,1999,1
howard fast,The Immigrants (Immigrants Saga),2000,31,0,3,2000,0
howard fast,Spartacus,2000,32,0,2,2000,0
howard fast,Redemption,2001,33,0,4,2000,1
howard fast,Moses : Prince of Egypt,2001,34,3,3,2001,0
howard fast,Bunker Hill,2001,35,0,1,2001,0
howard fast,Greenwich,2002,36,5,2,2001,1
howard fast,The Immigrants,2004,37,5,1,2002,2
howard fast,The Immigrant's Daughter,2004,38,6,1,2004,0
howard liss,The Giant Book of Strange but True Sports Stories,1976,2,4.333333333333333,3,1975,1
howard liss,The Giant Book of More Strange but True Sports Stories,1983,3,0,4,1976,7
howard liss,Strange but True Basketball Stories (Random House sports library),1983,4,10,1,1983,0
howard liss,Strange but True Football Stories (Random House sports library),1983,5,0,1,1983,0
howard m. shapiro,Dr. Shapiro's Picture Perfect Weight Loss Shopper's Guide : Supermarket Choices for Permanent Weight Loss,2001,2,0,1,2000,1
howard m. shapiro,Dr. Shapiro's Picture Perfect Weight Loss 30 Day Plan,2002,3,2.75,4,2001,1
howard m. shapiro,Dr. Shapiro's Picture Perfect Weight Loss Cookbook: More Than 150 Delicious Recipes for Permanent Weight Loss,2003,4,0,1,2002,1
howard m. shapiro,Dr. Shapiro's Picture Perfect Weight Loss : The Visual Program for Permanent Weight Loss,2003,5,0,2,2003,0
howard pyle,Men of Iron,1979,2,0,1,1965,14
howard pyle,The Story of King Arthur and His Knights,1981,3,0,3,1979,2
howard pyle,Merry Adventures of Robin Hood (Illustrated Junior Library),1981,4,0,1,1981,0
howard pyle,Story of King Arthur and His Knights (Companion Library),1984,5,0,1,1981,3
howard pyle,Story of King Arthur and His Knights,1986,6,0,2,1984,2
howard pyle,Readers Digest Best Loved Books for Young Readers: The Merry Adventures of Robin Hood (Best Loved Books for Young Readers),1989,7,0,2,1986,3
howard pyle,Merry Adventures of Robin Hood (Great Illustrated Classics),1990,8,10,1,1989,1
howard pyle,"The Merry Adventures of Robin Hood: Of Great Renown, in Nottinghamshire",1991,9,5,2,1990,1
howard pyle,The Adventures of Robin Hood (Illustrated Classics),1991,10,0,1,1991,0
howard pyle,Robin Hood (Penguin Popular Classics),1997,11,8,2,1991,6
howard pyle,Men of Iron,1998,12,0,1,1997,1
howard pyle,King Arthur and the Knights of the Round Table (Illustrated Classics Editions),2002,13,0,3,1998,4
howard pyle,Men of Iron (Timeless Classics),2003,14,0,2,2002,1
howard pyle,The Wonder Clock (Starscape),2003,15,9,1,2003,0
howard schultz,Pour Your Heart Into It: How Starbuck Built a Company One Cup at a Time,1997,2,4,2,1997,0
howard schultz,Pour Your Heart into It : How Starbucks Built a Company One Cup at a Time,1999,3,9.5,2,1997,2
howard teichmann,"Fonda, My Life (Signet Books)",1991,2,1.4,5,1979,12
howard zehr,The Little Book of Restorative Justice (The Little Books of Justice &amp; Peacebuilding),2002,2,10,1,2001,1
hua-ching ni,"8,000 Years of Wisdom (Book II)",1983,2,7,1,1983,0
hua-ching ni,Footsteps of the Mystical Child: The Path of Spiritual Evolution,1986,3,0,2,1983,3
hua-ching ni,Attaining Unlimited Life: Teachings of Chuang Tzu,1989,4,0,1,1986,3
hua-ching ni,Attune Your Body With Dao-In,1989,5,0,1,1989,0
hua-ching ni,"Eternal Light: Teachings of My Father, Grandmaster Ni Yo-San",1989,6,0,1,1989,0
hua-ching ni,Enlightenment: the Mother of Spiritual Independence,1989,7,0,1,1989,0
hua-ching ni,"Enlightenment, Mother of Spiritual Independence: Teachings of Hui Neng",1989,8,5,1,1989,0
hua-ching ni,The Gentle Path of Spiritual Progress,1990,9,0,1,1989,1
hua-ching ni,Spiritual Messages From a Buffalo Rider: A Man of Tao,1990,10,5,1,1990,0
hua-ching ni,Essence of Universal Spirituality,1990,11,0,1,1990,0
hua-ching ni,Internal Alchemy: The Natural Way to Immortality,1992,12,5,2,1990,2
hua-ching ni,Esoteric Tao Teh Ching,1992,13,0,1,1992,0
hua-ching ni,"The Way, the Truth and the Light: The Story of a Prophet",1993,14,5,1,1992,1
hua-ching ni,Gate to Infinity: Realizing Your Ultimate Potential,1995,15,8,1,1993,2
hua-ching ni,Concourse of All Spiritual Paths,1995,16,0,1,1995,0
hua-ching ni,The Power of Natural Healing,1995,17,7,1,1995,0
hua-ching ni,Spring Thunder: Awaken the Hibernating Power of Life,1996,18,4,2,1995,1
hua-ching ni,From Diversity to Unity: Return to the One Spiritual Source,1996,19,0,1,1996,0
hua-ching ni,Entering the Tao,1997,20,0,1,1996,1
hua-ching ni,Enrich Your Life with Virtue,1999,21,0,1,1997,2
hua-ching ni,The Centermost Way: Touchstone of Universal Life,2001,22,0,1,1999,2
hudson rivers,Five Fingers,1983,2,0,1,1981,2
hudson rivers,The Five Fingers,1991,3,0.3333333333333333,3,1983,8
hugh hewitt,"In, But Not Of : A Guide to Christian Ambition",2003,2,10,1,1996,7
hugh hewitt,"If It's Not Close, They Can't Cheat: Crushing the Democrats in Every Election and Why Your Life Depends on It",2004,3,0,1,2003,1
hugh holton,Windy City,1996,2,4.333333333333333,3,1995,1
hugh holton,Chicago Blues (Larry Cole),1997,3,0,1,1996,1
hugh holton,Red Lightning,1998,4,0,1,1997,1
hugh holton,Violent Crimes,1998,5,0,7,1998,0
hugh holton,Red Lightning,1999,6,1.8,5,1998,1
hugh holton,The Left Hand of God,2000,7,0,7,1999,1
hugh holton,Time of the Assassins,2000,8,10,1,2000,0
hugh holton,Time of the Assassins,2001,9,9,1,2000,1
hugh holton,The Devil's Shadow,2001,10,9,1,2001,0
hugh holton,Criminal Element,2002,11,8,1,2001,1
hugh holton,The Devil's Shadow (Larry Cole),2002,12,8,1,2002,0
hugh o'neill,"Here's Looking at You, Kids: The Crowded Romance of Mom and Dad",1992,2,0,1,1991,1
hugh o'neill,A Man Called Daddy : A Celebration of Fatherhood,1996,3,0,1,1992,4
hugh o'neill,The Doctors Book of Home Remedies for Preventing Disease: Tips and Techniques So Powerful They Stop Diseases Before They Start,1999,4,0,1,1996,3
hunter s thompson,"The Proud Highway: Saga of a Desperate Southern Gentleman 1955-1967 (Fear and Loathing Letters/Hunter S. Thompson, Vol 1)",1997,2,0,1,1973,24
i. shah,The Sufis,1971,2,5.75,4,1971,0
i. shah,Magic Monastery,1972,3,9.5,2,1971,1
i. shah,Exploits of the Incomparable Mulla Nasrudin,1972,4,10,1,1972,0
ian cochrane,The Slipstream,1985,2,0,1,1973,12
ian irvine,"The Tower on the Rift (The View from the Mirror, Book 2)",2002,2,5.666666666666667,3,2001,1
ian irvine,"The Way Between the Worlds (The View From the Mirror, Book 4)",2002,3,4,2,2002,0
ian irvine,"Dark Is the Moon (The View From the Mirror, Book 3)",2002,4,4.5,2,2002,0
ian livingstone,ISLAND OF THE LIZARD (Fighting Fantasy #7),1984,2,0,1,1982,2
ian livingstone,Ian Livingstone's Caverns of the Snow Witch (Fighting Fantasy Gamebook),1984,3,6,1,1984,0
ian livingstone,Caverns of the Snow,1985,4,0,1,1984,1
ian livingstone,The Forest of Doom,1985,5,0,1,1985,0
ian livingstone,Dicing With Dragons: An Introduction to Role-Playing Games,1986,6,0,2,1985,1
ian livingstone,Darkmoon's Curse (Adventures of Goldhawk),1995,7,0,1,1986,9
ian livingstone,Adventures of Goldhawk (First Fighting Fantasy Adventure S.),1995,8,0,1,1995,0
ian mcmahan,Lake Fear (Microdkid Mystery),1985,2,0,1,1984,1
ian mcmahan,"Get It Done!: A Guide to Motivation, Determination and Achievement",1996,3,0,1,1985,11
ian ousby,Guilty Parties: A Mystery Lover's Companion,1997,2,9,2,1993,4
ian stewart,Does God Play Dice: The Mathematics of Chaos,1990,2,8,1,1987,3
ian stewart,Fearful Symmetry: Is God a Geometer? (Penguin Science),1993,3,0,1,1990,3
ian stewart,Nature's Numbers: The Unreal Reality of Mathematical Imagination (Science Masters Series),1995,4,0,2,1993,2
ian stewart,Nature's Numbers: Discovering Order and Pattern in the Universe (Science Masters),1996,5,8,1,1995,1
ian stewart,Wheelers,2000,6,3.5,8,1996,4
ian stewart,"Flatterland: Like Flatland, Only More So",2001,7,0,1,2000,1
ian stewart,Wheelers,2001,8,0,4,2001,0
ian stewart,"Flatterland: Like Flatland, Only More So",2002,9,2.75,8,2001,1
ian stewart,Ambushed: A War Reporter's Life on the Line,2002,10,0,1,2002,0
ian stewart,Heaven,2004,11,10,1,2002,2
ian stuart black,"Doctor Who: The War Machines (Dr. Who Library, No. 136)",1989,2,0,1,1988,1
iceberg slim,"""Sapphire Presents: \Pimp - the Story of My Life"""" (Sapphire Presents)""""""",1998,2,0,1,1987,11
iceberg slim,Mama Black Widow (Old School Books),1998,3,0,1,1998,0
iceberg slim,Mama Black Widow: A Story of the South's Black Underworld,2002,4,0,1,1998,4
iceberg slim,Pimp: The Story of My Life,2002,5,9,1,2002,0
iceberg slim,The Naked Soul of Iceberg Slim,2002,6,6,1,2002,0
ida chittum,The Cat's Pajamas,1980,2,0,2,1975,5
ida luttrell,The Bear Next Door (An I Can Read Book),1991,2,0,1,1985,6
ilan duran cohen,Mon cas personnel,2002,2,0,1,2001,1
ina may gaskin,Spiritual Midwifery,1990,2,5.666666666666667,3,1980,10
ina may gaskin,Spiritual Midwifery,2002,3,10,1,1990,12
inc. book sales,Mexican Snacks &amp; Salsas,1996,2,0,1,1992,4
inc. book sales,A Century of Gay Erotica,1998,3,2,3,1996,2
inc. book sales,The Pre-Raphaelites (Centuries of Style),1998,4,0,1,1998,0
inc. syngress media,MCSD Analyzing Requirements: Exam 70-100 (MCSD Study Guides),1999,2,0,1,1999,0
indira ganesan,Inheritance (Bluestreak),1999,2,0,1,1990,9
indira ganesan,Das GlÃ?Â¼ck jenseits des Meeres.,2001,3,0,1,1999,2
inglis clark fletcher,"Toil of the Brave (Carolina Chronicles, Book 6)",1986,2,3,2,1986,0
insight guides,Insight Guides London (Insight Guides),1992,2,7,1,1991,1
insight guides,Native America: Insight City Guides,1992,3,9,1,1992,0
insight guides,Insight Guide: Rome (Insight Guide Rome),1993,4,7,1,1992,1
insight guides,Insight Pocket Guides Paris (Insight Pocket Guides),1998,5,10,1,1993,5
iona archibald opie,Wee Willie Winkie: And Other Rhymes (My Very First Mother Goose),1997,2,4,2,1992,5
iona archibald opie,Pussycat Pussycat: And Other Rhymes (My Very First Mother Goose),1997,3,10,1,1997,0
iona archibald opie,Humpty Dumpty: And Other Rhymes (My Very First Mother Goose),1997,4,0,1,1997,0
iona archibald opie,Little Boy Blue: And Other Rhymes (My Very First Mother Goose),1997,5,0,1,1997,0
iona archibald opie,"The Oxford Dictionary of Nursery Rhymes (Oxford Dictionary Nursery Rhymes, 2nd ed)",1998,6,5,2,1997,1
iona archibald opie,Here Comes Mother Goose,1999,7,0,1,1998,1
ira genberg,Reckless Homicide (Reckless Homicide),1998,2,0,8,1998,0
irene b. brand,German Enchantment: A Legacy of Customs and Devotion in Four Romantic Novellas,2002,2,0,2,1988,14
irene bennett brown,Haven (Five Star Expressions.),2003,2,9,1,1985,18
irene dische,Die intimen GestÃ?Â¤ndnisse des Oliver Weinstock. Wahre und erfundene Geschichten.,1996,2,0,2,1991,5
irene dische,Strange Traffic: Stories,1997,3,0,1,1996,1
irene dische,Ein Job.,2002,4,3,2,1997,5
irene trimble,Zak &amp; Wheezie: Clean Up (Dragon Tales (Ctw Books).),2000,2,0,3,1999,1
irene trimble,Crocodiles (Know-It-Alls (Hardcover)),2000,3,4,2,2000,0
irene trimble,Cassie Loves a Parade (Dragon Tales),2000,4,0,3,2000,0
irene trimble,Wheezie Loses Her Voice (Jellybean Books),2001,5,3.5,2,2000,1
irene trimble,Max and Emmy's Flower Power (Pictureback Shape),2001,6,8.5,2,2001,0
irene trimble,Pirates of the Caribbean: The Junior Novelization,2003,7,1.3571428571428572,14,2001,2
irene zahava,The Womansleuth Anthology: Contemporary Mystery Stories by Women (Womansleuth Series),1988,2,0,1,1986,2
irene zahava,Lesbian Love Stories,1989,3,0,2,1988,1
irene zahava,The Second Womansleuth Anthology: Contemporary Mystery Stories by Women,1989,4,0,2,1989,0
irene zahava,The Third Womansleuth Anthology: Contemporary Mystery Stories by Women (Womansleuth Mystery Series),1990,5,0,2,1989,1
irene zahava,My Mother's Daughter: Stories by Women,1991,6,0,4,1990,1
irina ratushinskaia,Grey is the color of hope,1989,2,4.5,2,1988,1
irina ratushinskaia,The Odessans,1996,3,0,1,1989,7
iris gower,The Sins of Eden,1992,2,0,2,1987,5
iris gower,Firebird,2000,3,8,1,1992,8
iris gower,Spinner's Wharf,2000,4,0,2,2000,0
iris gower,The Shoemaker's Daughter,2000,5,0,1,2000,0
iris gower,The Wild Seed,2000,6,0,1,2000,0
iris gower,Proud Mary,2000,7,0,1,2000,0
iris rainer dart,TILL THE REAL THING COMES ALONG,1988,2,0,2,1986,2
iris rainer dart,Beaches,1990,3,3.6363636363636362,22,1988,2
iris rainer dart,I'll Be There,1991,4,2.875,8,1990,1
iris rainer dart,Beaches II: I'll Be There,1992,5,1.5789473684210527,19,1991,1
iris rainer dart,The Stork Club: A Novel,1992,6,0,3,1992,0
iris rainer dart,Show Business Kills: A Novel,1995,7,0,1,1992,3
iris rainer dart,Show Business Kills,1996,8,1.6,5,1995,1
iris rainer dart,When I Fall in Love,1999,9,3.7142857142857144,7,1996,3
irma kurtz,Irma Kurtz's Ult Prob.so,1995,2,0,2,1993,2
irma kurtz,Dear London: Notes from the big city,1997,3,7,1,1995,2
irma s. rombauer,JOY OF COOKING CHRISTMAS COOKIES,1996,2,5,1,1985,11
irma s. rombauer,Joy of Cooking,1997,3,8.666666666666666,3,1996,1
irma s. rombauer,"Joy of Cooking: Main Course Dishes (Joy of Cooking , No 1)",1998,4,0,2,1997,1
irma s. rombauer,Joy of Cooking: All About Soups and Stews,2000,5,0,1,1998,2
irma s. rombauer,Joy of Cooking: All About Cookies,2002,6,10,1,2000,2
irving m. zeitlin,Ideology and the Development of Sociological Theory,1989,2,7,1,1988,1
irving stone,Agony and Ecstasy,1963,2,0,3,1963,0
irving stone,Vincent van Gogh. Ein Leben in Leidenschaft.,1968,3,0,1,1963,5
irving stone,Dear Theo: The Autobiography of Vincent Van Gogh,1969,4,2.6666666666666665,3,1968,1
irving stone,Clarence Darrow for the Defense,1976,5,0,1,1969,7
irving stone,Jack London: Sailor on Horseback,1978,6,6,1,1976,2
irving stone,The Origin: A Biographical Novel of Charles Darwin,1980,7,0,1,1978,2
irving stone,Love Is Eternal,1981,8,0,1,1980,1
irving stone,Origin,1982,9,2,14,1981,1
irving stone,Men to Match My Mountains,1982,10,5,1,1982,0
irving stone,Men to Match My Mountains,1982,11,7,1,1982,0
irving stone,Lust for life (Plume fiction),1984,12,9,1,1982,2
irving stone,Depths of Glory,1987,13,0,6,1984,3
irving stone,Agony and the Ecstasy,1987,14,2,2,1987,0
irving stone,Men to Match My Mountains,1987,15,2,4,1987,0
irving stone,Lust for Life,1989,16,4.416666666666667,12,1987,2
irving stone,Love Is Eternal: A Novel About Mary Todd and Abraham Lincoln,1990,17,0,1,1989,1
irving stone,Depths of Glory,1990,18,0,1,1990,0
irving stone,The Passion of the Minds,1994,19,0,1,1990,4
irving stone,The Agony and the Ecstasy: A Biographical Novel of Michelangelo,1996,20,4.6521739130434785,23,1994,2
irving stone,The President's Lady : A Novel about Rachel and Andrew Jackson,1996,21,5,2,1996,0
irving stone,Michelangelo.,1997,22,0,1,1996,1
irving stone,Vincent van Gogh. Ein Leben in Leidenschaft.,2002,23,7,1,1997,5
isaac kramnick,The Godless Constitution: The Case Against Religious Correctness,1997,2,0,1,1996,1
isabel stanley,Beadwork (New Crafts),1997,2,0,1,1995,2
isabelle holland,Journey for three,1974,2,0,2,1972,2
isabelle holland,Tower Abbey,1979,3,0,1,1974,5
isabelle holland,Alan and the Animal Kingdom,1979,4,0,1,1979,0
isabelle holland,Summer of My First Love,1981,5,1.25,4,1979,2
isabelle holland,A Death at St. Anselm's,1985,6,8,1,1981,4
isabelle holland,Dinah and the Green Fat Kingdom,1986,7,8,1,1985,1
isabelle holland,Love and the Genetic Factor,1987,8,0,1,1986,1
isabelle holland,The man without a face,1987,9,5,2,1987,0
isabelle holland,The Man Without a Face (Keypoint Book),1987,10,4.2,10,1987,0
isabelle holland,Dinah and the Green Fat Kingdom,1988,11,0,1,1987,1
isabelle holland,Now Is Not Too Late,1991,12,0,1,1988,3
isabelle holland,The Long Search,1992,13,0,1,1991,1
isabelle holland,The Journey Home,1993,14,6,1,1992,1
isabelle holland,Behind the Lines (Point),1997,15,1.4,5,1993,4
isak dinesen,Out of Africa,1972,2,1.8666666666666667,15,1972,0
isak dinesen,Anecdotes of destiny,1974,3,2.6666666666666665,3,1972,2
isak dinesen,Last tales,1975,4,0,1,1974,1
isak dinesen,Out of Africa (Time reading program special edition),1980,5,0,1,1975,5
isak dinesen,Letters from Africa 1914-1931,1984,6,0,1,1980,4
isak dinesen,Seven Gothic Tales,1985,7,8,1,1984,1
isak dinesen,Winters Tale,1985,8,0,2,1985,0
isak dinesen,"Out of Africa ; and, Shadows on the grass",1985,9,1.625,56,1985,0
isak dinesen,"Anecdotes of destiny ; and, Ehrengard",1985,10,7,1,1985,0
isak dinesen,Out of Africa and Shadows on the Grass (G K Hall Large Print Book Series),1986,11,0,2,1985,1
isak dinesen,On Modern Marriage and Other Observations,1987,12,0,1,1986,1
isak dinesen,Babette's Feast &amp; Other Anecdotes of Destiny,1988,13,0,6,1987,1
isak dinesen,Out of Africa,1988,14,9,1,1988,0
isak dinesen,Babette's Feast &amp; Other Anecdotes of Destiny,1988,15,7,1,1988,0
isak dinesen,Out of Africa and Shadows on the Grass (Vintage International),1989,16,0.5384615384615384,13,1988,1
isak dinesen,Last Tales,1991,17,0,1,1989,2
isak dinesen,Seven Gothic Tales,1991,18,4.5,4,1991,0
isak dinesen,Out of Africa (Modern Library),1992,19,4.333333333333333,9,1991,1
isak dinesen,Winter's Tales (Vintage International),1993,20,6,3,1992,1
isak dinesen,"Anecdotes of Destiny ; And, Ehrengard: And, Ehrengard (Vintage International)",1993,21,4,2,1993,0
isak dinesen,Memorias de Africa - B -,1994,22,2.3333333333333335,3,1993,1
isak dinesen,Siete Cuentos Goticos,1997,23,9,1,1994,3
isak dinesen,"Familia Cats, La",1998,24,0,1,1997,1
isak dinesen,Memorias de Africa - Bolsillo,2001,25,0,3,1998,3
isak dinesen,Out of Africa,2002,26,3.5,2,2001,1
isolde heyne,Hexenfeuer.,1997,2,3,4,1995,2
ivars  peterson,Math Trek : Adventures in the Math Zone,1999,2,10,1,1997,2
ivars  peterson,Fragments of Infinity: A Kaleidoscope of Math and Art,2001,3,0,1,1999,2
j. (jiddu) krishnamurti,La flamme de l'attention,1998,2,0,1,1995,3
j. allan hobson,Out of Its Mind: Psychiatry in Crisis,2001,2,0,1,1989,12
j. b. stamper,More Tales for the Midnight Hour: J.B. Stamper,1987,2,0,3,1986,1
j. b. stamper,Still More Tales for the Midnight Hour,1989,3,2.3333333333333335,3,1987,2
j. b. stamper,Still More Tales for the Midnight Hour (Point),1992,4,0,2,1989,3
j. b. stamper,More Night Frights: Thirteen Scary Stories,1993,5,0,1,1992,1
j. b. stamper,Night Frights: Thirteen Scary Stories,1997,6,0.4166666666666667,12,1993,4
j. b. stamper,101 Wacky Computer Jokes,1998,7,1.4,5,1997,1
j. david kuo,dot.bomb: My Days and Nights at an Internet Goliath,2001,2,3.5,2,2001,0
j. david kuo,dot.bomb: My Days and Nights at an Internet Goliath,2002,3,0,1,2001,1
j. j armas marcelo,Los dioses de sÃ­ mismos,1989,2,0,1,1978,11
j. j armas marcelo,El arbol del bien y del mal (Biblioteca bÃ¡sica canaria),1989,3,0,1,1989,0
j. j armas marcelo,"Madrid, Distrito Federal (Biblioteca breve)",1994,4,1,1,1989,5
j. j armas marcelo,Cuando Ã©ramos los mejores,1997,5,6,1,1994,3
j. m. barrie,Peter Pan (Heirloom Classic),1987,2,0,1,1986,1
j. m. barrie,Peter Pan (Little Unicorn),1988,3,0,1,1987,1
j. m. barrie,Peter Pan (Classics for Young Readers),1993,4,0,1,1988,5
j. m. barrie,Peter Pan (Apple Classics),1993,5,6.666666666666667,3,1993,0
j. m. barrie,Peter Pan (Puffin Classics),1996,6,6.5,4,1993,3
j. m. barrie,What Every Woman Knows (Dover Thrift Editions),1997,7,4.5,2,1996,1
j. m. barrie,Peter Pan (Wordsworth Collection),1998,8,2.5,4,1997,1
j. m. barrie,Peter Pan in Kensington Gardens : Peter and Wendy (Oxford World's Classics),1999,9,2,5,1998,1
j. m. barrie,Peter Pan (Book and Charm),2000,10,3.3333333333333335,3,1999,1
j. m. barrie,Peter Pan (Scholastic Classics),2002,11,0,1,2000,2
j. m. barrie,Peter Pan (Dalmatian Press Adapted Classic),2002,12,5,2,2002,0
j. m. barrie,Peter Pan,2003,13,8,1,2002,1
j. m. barrie,Peter Pan Deluxe Book and Charm (Charming Classics),2003,14,8,1,2003,0
j. m. barrie,Peter Pan (Signet Classics),2003,15,2.6666666666666665,3,2003,0
j. m. barrie,Peter Pan,2003,16,3.5,2,2003,0
j. m. barrie,Peter Pan,2003,17,2.6666666666666665,3,2003,0
j. m. barrie,Peter Pan: The Original Story (Peter Pan),2003,18,3.727272727272727,11,2003,0
j. m. g. le clezio,L'inconnu sur la terre,2001,2,0,1,2000,1
j. madison davis,Law and Order Deadline : An Original Law and Order Novel (Law &amp; Order (Ibooks)),2004,2,0,2,2002,2
j. patrick law,The Assistant,2001,2,0,1,2000,1
j. paul hunter,The Norton Introduction to Poetry,1995,2,5,2,1986,9
j. paul hunter,The Norton Introduction to Poetry,1998,3,4,2,1995,3
j. randy taraborrelli,Michael Jackson: The Magic and the Madness,1991,2,5.5,4,1989,2
j. randy taraborrelli,Call Her Miss Ross: The Unauthorized Biography of Diana Ross,1991,3,0,2,1991,0
j. randy taraborrelli,Michael Jackson: The Magic and the Madness,1992,4,0,1,1991,1
j. randy taraborrelli,Jackie Ethel Joan : Women of Camelot,2000,5,1,4,1992,8
j. randy taraborrelli,"Jackie, Ethel, Joan : Women of Camelot",2000,6,0,1,2000,0
j. randy taraborrelli,"Jackie, Ethel, Joan : Women of Camelot",2000,7,2.6666666666666665,3,2000,0
j. randy taraborrelli,Madonna: An Intimate Biography,2001,8,2.6666666666666665,3,2000,1
j. randy taraborrelli,Once Upon a Time: Behind the Fairy Tale of Princess Grace and Prince Rainier,2003,9,6.333333333333333,3,2001,2
j. randy taraborrelli,Once Upon a Time : Behind the Fairy Tale of Princess Grace and Prince Rainier,2004,10,1,2,2003,1
j. robert king,Carnival of Fear (Ravenloft),1993,2,0,5,1992,1
j. robert king,Realms of the Underdark (Forgotten Realms Anthology),1996,3,0,3,1993,3
j. robert king,Abyssal Warriors (Abyssal Warriors),1996,4,0,4,1996,0
j. robert king,"Blood Hostages (Blood Wars Trilogy , No 1)",1996,5,0,9,1996,0
j. robert king,"Vinas Solamnus (Dragonlance Lost Legends, Vol. 1)",1997,6,5.2,5,1996,1
j. robert king,"Planar Powers (Blood Wars Trilogy , No 3)",1997,7,0,1,1997,0
j. robert king,"The Thran (Magic, The Gathering)",1999,8,0,1,1997,2
j. robert king,Lancelot Du Lethe,2001,9,0,1,1999,2
j. robert king,"Apocalypse (Invasion Cycle, Book III)",2001,10,0,1,2001,0
j. robert king,Mad Merlin (Mad Merlin),2001,11,4.6,5,2001,0
j. robert king,Lancelot Du Lethe (Mad Merlin),2003,12,2.6,5,2001,2
j. robert king,Le Morte D'Avalon (Arthurian Novel),2003,13,10,1,2003,0
j. s. borthwick,The Down East Murders,1991,2,0,1,1991,0
j. s. borthwick,The Case of the Hook-Billed Kites (Dead Letter Mysteries),1991,3,4,2,1991,0
j. s. borthwick,Dolly Is Dead,1995,4,8,1,1991,4
j. s. borthwick,The Garden Plot (Dead Letter Mysteries),1998,5,0,4,1995,3
j. s. borthwick,Coup De Grace,2000,6,0,1,1998,2
j. s. borthwick,My Body Lies over the Ocean (Sarah Deane Mysteries),2000,7,4,2,2000,0
j. s. borthwick,Coup de Grace : A Sarah Deane Mystery (A Sarah Deane Mystery),2001,8,2,4,2000,1
j. s. borthwick,Murder in the Rough,2002,9,4,2,2001,1
j. s. borthwick,Murder in the Rough : A Sarah Deane Mystery (A Sarah Deane Mystery),2003,10,9,1,2002,1
j. s. borthwick,Intensive Scare Unit,2004,11,9,1,2003,1
j.l. carr,HOW STEEPLE SIND WON FA C,1986,2,7,1,1984,2
j.l. carr,The Battle of Pollock's Crossing,1993,3,8,1,1986,7
j.m. morris,Fiddleback: A Novel,2003,2,0,3,2002,1
jack  volhard,Dog Training for Dummies,2001,2,0,1,1991,10
jack brennan,No Quarter,1999,2,0,1,1997,2
jack brennan,Straight Talk on Investing: What You Need to Know,2002,3,0,1,1999,3
jack cohen,Wheelers,2001,2,0,1,1995,6
jack curtis,Crow's Parliament,1988,2,0,1,1987,1
jack curtis,Glory,1989,3,0,1,1988,1
jack curtis,The Sheriff Kill,1991,4,0,1,1989,2
jack curtis,TEXAS RULES,1991,5,0,1,1991,0
jack curtis,Point of Impact,1991,6,0,1,1991,0
jack curtis,Point of Impact,1993,7,0,1,1991,2
jack curtis,The QUICK AND THE DEAD (MOVIE TIE-IN) (Movie-Tie-in),1995,8,0,1,1993,2
jack curtis,Der Schrei der Schwalbe. Roman.,2003,9,0,1,1995,8
jack dann,Unicorns,1984,2,6,1,1982,2
jack dann,Magicats,1984,3,2.6666666666666665,6,1984,0
jack dann,Unicorns,1984,4,1.75,4,1984,0
jack dann,Sorcerers!,1986,5,4,2,1984,2
jack dann,Bestiary!,1986,6,0,1,1986,0
jack dann,Demons (Magic Tales Anthology Series),1987,7,0,1,1986,1
jack dann,Dogtales (Magic Tales Anthology Series),1988,8,3.5,2,1987,1
jack dann,Dinosaurs!,1990,9,0,1,1988,2
jack dann,Magicats II,1991,10,1.1666666666666667,6,1990,1
jack dann,Unicorns II (Magic Tales Anthology Series),1992,11,0,3,1991,1
jack dann,Dragons!,1993,12,0,1,1992,1
jack dann,Invaders!,1993,13,0,1,1993,0
jack dann,Horses!,1994,14,8,1,1993,1
jack dann,The Memory Cathedral: A Secret History of Leonardo Da Vinci,1996,15,4,6,1994,2
jack dann,Hackers,1996,16,5,1,1996,0
jack dann,Timegates,1997,17,9,1,1996,1
jack dann,Clones (Ace Science Fiction),1998,18,3,3,1997,1
jack dann,Immortals,1998,19,0,1,1998,0
jack dann,Nebula Awards 32: SFWA's Choices for the Best Science Fiction and Fantasy of the Year,1998,20,4.5,2,1998,0
jack dann,Die Kathedrale der Erinnerung. Das geheime Leben des Leonardo da Vinci.,1998,21,2.5,2,1998,0
jack dann,Armageddons,1999,22,9,2,1998,1
jack dann,Future War,1999,23,0,3,1999,0
jack dann,The Silent,1999,24,0,3,1999,0
jack dann,Dreaming Down-Under,2000,25,0,1,1999,1
jack dann,Aliens Among Us,2000,26,1.75,4,2000,0
jack dann,Genometry (Ace Science Fiction),2001,27,0,3,2000,1
jack dann,"Der Tag, an dem ich unsichtbar wurde.",2001,28,4.5,2,2001,0
jack dann,Space Soldiers,2001,29,0,1,2001,0
jack dann,Future Sports,2002,30,0,1,2001,1
jack dann,Counting Coup,2002,31,0,1,2002,0
jack dann,Dreaming Down-Under,2002,32,9,1,2002,0
jack dann,Visitations (Five Star First Edition Speculative Fiction Series),2003,33,9,1,2002,1
jack dann,The Rebel : An Imagined Life of James Dean,2004,34,8,1,2003,1
jack early,Donato and Daughter,1989,2,5,1,1988,1
jack early,A Creative Kind of Killer,1995,3,7,1,1989,6
jack germond,Fat Man in a Middle Seat: Forty Years of Covering Politics,2002,2,0,1,1999,3
jack handey,Deep Thoughts,1994,2,6.909090909090909,11,1993,1
jack handey,Deepest Thoughts : So Deep They Squeak,1994,3,3.5,2,1994,0
jack handey,Fuzzy Memories,1996,4,4,2,1994,2
jack handey,Lost Deep Thoughts : Don't Fight the Deepness,1998,5,9,2,1996,2
jack harris,Step-By-Step Book About Iguanas (Step-By-Step Book About Series),1990,2,3.5,2,1988,2
jack hayford,"I'll Hold You in Heaven: Healings and Hope for the Parent of a Miscarried, Aborted, or Stillborn Child",1990,2,6.25,4,1987,3
jack hayford,The Key to Everything,1993,3,0,1,1990,3
jack hayford,Worship His Majesty,1994,4,0,1,1993,1
jack hayford,Pursuing The Will of God,1997,5,0,1,1994,3
jack hoffenberg,Desperate Adversaries,1976,2,0,2,1975,1
jack hoffenberg,A Time for Pagans,1977,3,0,1,1976,1
jack kornfield,A Path With Heart: A Guide Through the Perils and Promises of Spiritual Life,1993,2,2.3333333333333335,6,1993,0
jack kornfield,Buddha's Little Instruction Book,1994,3,5.5,8,1993,1
jack kornfield,Soul Food: Stories to Nourish the Spirit and the Heart,1996,4,4.4,5,1994,2
jack kornfield,The Heart of Spiritual Practice,1997,5,10,1,1996,1
jack kornfield,"After the Ecstasy, the Laundry: How the Heart Grows Wise on the Spiritual Path",2000,6,5.333333333333333,3,1997,3
jack kornfield,"After the Ecstasy, the Laundry: How the Heart Grows Wise on the Spiritual Path",2001,7,1.5,4,2000,1
jack kornfield,"The Art of Forgiveness, Lovingkindness, and Peace",2002,8,3.8,5,2001,1
jack miles,God: A Biography,1996,2,2.8,10,1995,1
jack miles,Christ: A Crisis in the Life of God,2001,3,2,1,1996,5
jack miles,Christ: A Crisis in the Life of God,2002,4,0,1,2001,1
jack moeller,Deutsch Heute,1992,2,0,1,1988,4
jack moeller,Deutsch Heute: Grundstufe,1996,3,10,1,1992,4
jack moeller,Deutsch Heute: Grundstufe : Arbeitsheft : Workbook/Lab Manual/Video Workbook,1997,4,8,1,1996,1
jack prather,He Never Said He Wouldn't,2003,2,10,1,2002,1
jack s. scott,"Corporal Smithers, Deceased",1983,2,0,1,1977,6
jack s. scott,All the Pretty People/#08124,1984,3,0,1,1983,1
jack smith,Eternally Yours,1996,2,0,1,1985,11
jack smith,God and Mr. Gomez: Building a Dream House in Baja,1997,3,8,1,1996,1
jack trout,The New Positioning: The Latest on the World's #1 Business Strategy,1995,2,0,1,1982,13
jack trout,The Power of Simplicity,1998,3,8,1,1995,3
jack weyland,Lean on Me,1996,2,7,1,1987,9
jack ziegler,Worst Case Scenarios: A Collection of Cartoons,1990,2,7,1,1981,9
"jack, ph.d. myers",What Makes Popcorn Pop?: And Other Questions About the World Around Us,1994,2,5,2,1994,0
jackie french koller,Nothing to Fear,1993,2,0,1,1993,0
jackie french koller,The DRAGONLING : THE DRAGONLING (DRAGONLING),1995,3,0,2,1993,2
jackie french koller,A DRAGON IN THE FAMILY : A DRAGON IN THE FAMILY,1996,4,0,2,1995,1
jackie french koller,A Place to Call Home,1997,5,3,3,1996,1
jackie french koller,"Mole And Shrew Are Two (Stepping Stone,  paper)",2000,6,10,1,1997,3
jackie french koller,The Promise,2001,7,10,1,2000,1
jackie french koller,"Mole &amp; Shrew Have Jobs To Do (Stepping Stone,  paper)",2001,8,9,1,2001,0
jackie french koller,Mole and Shrew Find a Clue (Stepping Stone Book),2001,9,0,1,2001,0
jackie gay,Her Majesty: 21 Stories by Women,2003,2,0,1,1999,4
jackie waldman,"America, September 11: The Courage to Give: The Triumph of the Human Spirit",2001,2,0,1,1999,2
jackie waldman,"America, September 11th, the Courage to Give: The Triumph of the Human Spirit",2002,3,0,1,2001,1
jackson,James Joyces the Dubliners,2000,2,0,2,1989,11
jackson j. spielvogel,Western Civilization: Comprehensive Volume,1999,2,8,1,1997,2
jackson j. spielvogel,Western Civilization: Volume C: Since 1789,1999,3,0,1,1999,0
jackson j. spielvogel,Western Civilization: Volume A: To 1500,1999,4,0,1,1999,0
jacob grimm,Popular Folk Tales,1978,2,10,1,1976,2
jacob grimm,Snow White and Rose Red,1979,3,0,1,1978,1
jacob grimm,Grimm's Household Stories (Facsimile Classics Series),1979,4,0,1,1979,0
jacob grimm,Twelve Dancing Princesses,1979,5,0,1,1979,0
jacob grimm,Grimm's Fairy Tales (Bambi Classics Series),1981,6,10,1,1979,2
jacob grimm,The Golden Goose,1982,7,0,1,1981,1
jacob grimm,Selected Tales (Penguin Classics),1983,8,3.5,2,1982,1
jacob grimm,Snow-White and the Seven Dwarfs,1987,9,0,1,1983,4
jacob grimm,The Twelve Dancing Princesses,1989,10,9.5,2,1987,2
jacob grimm,Die Maerchen der Brueder Grimm,1990,11,3,1,1989,1
jacob grimm,Sleeping Beauty and Other Fairy Tales (Dover Children's Thrift Classics),1992,12,1.8,5,1990,2
jacob grimm,Favourite Tales: Rumpelstiltskin (Old Favourite Tales),1993,13,4,2,1992,1
jacob grimm,Fairy Tales (Henry Holt Little Classics),1994,14,10,1,1993,1
jacob grimm,Snow White and Other Fairy Tales (Dover Children's Thrift Classics),1995,15,0,1,1994,1
jacob grimm,Grimms' Fairy Tales (Illustrated Junior Library),1995,16,9,1,1995,0
jacob grimm,Grimms' Fairy Tales (Puffin Classics),1996,17,6.333333333333333,3,1995,1
jacob grimm,Grimm's Grimmest,1997,18,2.3333333333333335,12,1996,1
jacob grimm,The Six Swans: A Fairy Tale,1998,19,10,1,1997,1
jacob grimm,Rumpelstilzchen.,1998,20,9,1,1998,0
jacob grimm,Die schÃ?Â¶nsten MÃ?Â¤rchen der BrÃ?Â¼der Grimm.,1998,21,9,1,1998,0
jacob grimm,Cuentos de Grim,2001,22,9,1,1998,3
jacob grimm,Kinder- und HausmÃ?Â¤rchen. VollstÃ?Â¤ndige Ausgabe.,2002,23,6,1,2001,1
jacob grimm,The Complete Fairy Tales of the Brothers Grimm,2003,24,1.75,4,2002,1
jacob grimm,Die BrÃ?Â¼der Grimm erzÃ?Â¤hlen TiermÃ?Â¤rchen.,2003,25,9,1,2003,0
jacqueline blix,"Getting a Life: Strategies for Simple Living, Based on the Revolutionary Program for Financial Freedom, Your Money or Your Life",1999,2,0,1,1997,2
jacqueline dauxois,NÃ?Â©fertiti,2001,2,0,1,1988,13
jacqueline dauxois,La reine de Saba,2001,3,0,1,2001,0
jacqueline shannon,Faking It,1989,2,0,1,1989,0
jacqueline shannon,Why Its Great to Be a Girl : 50 Things You Can Tell Your Daughter to Increase Her Pride in Being Female,1994,3,3.5,2,1989,5
jacqueline wilson,The Suitcase Kid,1997,2,0,1,1990,7
jacqueline wilson,The Suitcase Kid,1998,3,0,2,1997,1
jacqueline wilson,Double Act,1999,4,3.3333333333333335,3,1998,1
jacqueline wilson,How to Survive Summer Camp (Oxford Junior Fiction S.),1999,5,4,4,1999,0
jacqueline wilson,Cliffhanger,2000,6,0,2,1999,1
jacqueline wilson,The Illustrated Mum (Cover to Cover),2001,7,9,1,2000,1
jacqueline wilson,Verliebte Girls. ( Ab 12 J.).,2001,8,0,1,2001,0
jacqueline wilson,Vicky Angel,2001,9,0,1,2001,0
jacqueline wilson,Bad Girls,2002,10,9,1,2001,1
jacqueline wilson,Girls Under Pressure (Girls trilogy),2002,11,0,2,2002,0
jacqueline wilson,Girls Out Late,2002,12,8,1,2002,0
jacqueline wilson,Tattoo Mum. ( Ab 11 J.).,2002,13,0,2,2002,0
jacqueline wilson,"Girls in Love (Girls Trilogy, Book 1)",2002,14,3.8,5,2002,0
jacqueline wilson,Girls in Love,2002,15,2.25,4,2002,0
jacqueline wilson,The Story of Tracy Beaker,2002,16,2,4,2002,0
jacqueline wilson,Sleepovers,2002,17,0,2,2002,0
jacqueline wilson,Vicky Angel,2003,18,1.75,4,2002,1
jacqueline wilson,Girls Out Late,2003,19,0,2,2003,0
jacqueline wilson,"Girls Under Pressure (Girls Quartet, Book 2)",2003,20,0,1,2003,0
jacqueline wilson,"Illustrated Mum, The",2004,21,1.75,4,2003,1
jacqueline wilson,Girls in Tears (Girls Quartet),2004,22,0,1,2004,0
jacqueline wilson,The Illustrated Mum,2005,23,0,1,2004,1
jacques derrida,Dissemination,1983,2,0,1,1977,6
jacques derrida,The Truth in Painting,1987,3,9,1,1983,4
jacques derrida,Deconstruction in a Nutshell: A Conversation With Jacques Derrida (Perspectives in Continental Philosophy),1997,4,0,1,1987,10
jacques derrida,Of Grammatology,1998,5,8,1,1997,1
jacques derrida,The Work of Mourning,2001,6,0,1,1998,3
jacques duquennoy,The Ghost's Dinner,1996,2,0,1,1994,2
jacques lacan,"The Ethics of Psychoanalysis 1959-1960 (Seminar of Jacques Lacan (Paper), Bk 7)",1997,2,6,1,1982,15
jacques yves cousteau,Oasis in space,1975,2,0,1,1974,1
jacques yves cousteau,The Silent World,2004,3,7,1,1975,29
jake lamar,Rendezvous Eighteenth,2003,2,10,1,1996,7
jama kim rattigan,The Woman in the Moon: A Story from Hawai'I,1996,2,0,1,1993,3
james b. garfield,Follow My Leader,1994,2,0,3,1987,7
james b. twitchell,For Shame: The Loss of Common Decency in American Culture,1997,2,0,1,1987,10
james b. twitchell,Lead Us Into Temptation,2000,3,7,1,1997,3
james blaylock,The Stone Giant,1989,2,0,1,1989,0
james c. dobson,Dare to Discipline,1977,2,3.5,4,1977,0
james c. dobson,The Strong-Willed Child: Birth Through Adolescence,1978,3,9,2,1977,1
james c. dobson,Hide or Seek : How to Build Self-Esteem in Your Child,1979,4,7,1,1978,1
james c. dobson,Preparing for Adolescence Growth Guide,1979,5,0,1,1979,0
james c. dobson,Straight Talk to Men and Their Wives,1980,6,2.6666666666666665,3,1979,1
james c. dobson,Emotions You Can Trust Them,1982,7,8,1,1980,2
james c. dobson,Preparing for Adolescence,1983,8,0,1,1982,1
james c. dobson,Love Must Be Tough: New Hope for Families in Crisis,1983,9,5.4,5,1983,0
james c. dobson,Dr. Dobson Answers Your Questions about Feelings and Self-Esteem,1986,10,0,1,1983,3
james c. dobson,Parenting Isn't for Cowards: Dealing Confidently With the Frustrations of Child-Rearing,1988,11,1.25,8,1986,2
james c. dobson,Preparing for Adolescence: Caution: Changes Ahead,1989,12,0,2,1988,1
james c. dobson,Parenting Isn't for Cowards,1992,13,1.2857142857142858,7,1989,3
james c. dobson,The Strong-Willed Child: Birth Through Adolescence,1992,14,4.8,5,1992,0
james c. dobson,Children at Risk,1992,15,0,1,1992,0
james c. dobson,Love for a Lifetime: Building a Marriage That Will Go the Distance,1993,16,0,1,1992,1
james c. dobson,Love Must Be Tough,1996,17,8.5,2,1993,3
james c. dobson,Solid Answers: America's Foremost Family Counselor Responds to Tough Questions Facing Today's Families,1997,18,4,2,1996,1
james c. dobson,Dr. James Dobson on Parenting: The Strong-Willed Child : Parenting Isn't for Cowards,1997,19,3.6666666666666665,3,1997,0
james c. dobson,Life On The Edge,2000,20,4.75,8,1997,3
james c. dobson,The Complete Marriage and Family Home Reference Guide,2000,21,8,1,2000,0
james c. dobson,Bringing Up Boys: Practical Advice and Encouragement for Those Shaping the Next Generation of Men,2001,22,4.8,5,2000,1
james c. galvin,Promises from God's Word for Every Moment of Life,1996,2,0,1,1995,1
james cain,Dette de coeur,1986,2,0,1,1984,2
james cameron,James Cameron's Titanic,1997,2,0,1,1997,0
james cameron,Titanic: James Cameron's Illustrated Screenplay,1998,3,10,1,1997,1
james cameron,Terminator 2: Judgement Day : The Book of the Film : An Illustrated Screenplay (Applause Screenplay Series),2000,4,3,2,1998,2
james cameron,Ghosts of the Titanic,2000,5,0,2,2000,0
james champy,X-Engineering the Corporation: Reinventing Your Business in the Digital Age,2002,2,0,1,1995,7
james conroyd martin,Push Not The River,2003,2,3.5,8,2001,2
james e. martin,And Then You Die: A Gil Disbro Mystery,1993,2,0,1,1990,3
james e. martin,A Fine and Private Place: A Gil Disbro Mystery,1995,3,0,1,1993,2
james e. oberg,Pioneering Space: Living on the Next Frontier,1987,2,2.6666666666666665,3,1986,1
james f. twyman,Ten Spiritual Lessons I Learned at the Mall,2001,2,7,1,1997,4
james f. twyman,Emissary of Love: The Psychic Children Speak to the World,2002,3,6.2,5,2001,1
james f. twyman,The Proposing Tree: A Love Story,2003,4,2.3333333333333335,6,2002,1
"james f., md. balch",Prescription for Nutritional Healing A-To-Z Guide to Supplements: A Handy Resource to Today's Most Effective Nutritional Supplements (Prescription for Nutritional Healing: A-To-Z Guide to Supplements),1997,2,2.6666666666666665,6,1996,1
james finn garner,Politically Correct Bedtime Stories: Modern Tales for Our Life and Times,1994,2,0,4,1994,0
james finn garner,Once upon a More Enlightened Time: More Politically Correct Bedtime Stories,1995,3,3.4342105263157894,76,1994,1
james finn garner,Politically Correct Holiday Stories: For an Enlightened Yuletide Season,1995,4,3.810810810810811,37,1995,0
james finn garner,Apocalypse Wow,1997,5,2.5,22,1995,2
james finn garner,APOCALYPSE WOW: A MEMOIR FOR THE END OF TIME CASSETTE,1997,6,0,2,1997,0
james finn garner,"Politically Correct, the Ultimate Storybook: Politically Correct Bedtime Stories, Once upon a More Enlightened Time, and Politically Correct Holiday Stories",1998,7,2.789473684210526,19,1997,1
james finn garner,Apocalypse Wow : A Memoir for the End of Time,1999,8,3.5,2,1998,1
james finn garner,Cuentos Infantiles Politicamente Correctos,1999,9,0,4,1999,0
james frey,A Million Little Pieces,2003,2,4.142857142857143,7,1988,15
james frey,A Million Little Pieces,2004,3,3.3333333333333335,3,2003,1
james gelsey,"Scooby-Doo and the Mummy's Curse (Scoody-Doo Mysteries, 2)",1998,2,0,4,1998,0
james gelsey,"Scooby-Doo and the Vampire's Revenge (Scooby-Doo Mysteries, 6)",1999,3,0,1,1998,1
james gelsey,"Scooby-Doo! and the Carnival Creeper (Scooby-Doo Mysteries, 7)",1999,4,0,2,1999,0
james gelsey,"Scooby-Doo and the Howling Wolfman (Scooby-Doo Mysteries, 5)",1999,5,2.8333333333333335,6,1999,0
james gelsey,"Scooby-Doo! and the Snow Monster (Scooby-Doo Mysteries, 3)",1999,6,1.3333333333333333,9,1999,0
james gelsey,"Scooby-Doo! and the Sunken Ship (Scooby-Doo Mysteries, 4)",1999,7,0,3,1999,0
james gelsey,"Scooby Doo and the Fairground Phantom (Scooby-Doo Mysteries, 11)",2000,8,1.6666666666666667,6,1999,1
james gelsey,Scooby-Doo and You: The Case of the Glowing Alien (Scooby-Doo and You),2000,9,2.7142857142857144,7,2000,0
james gelsey,"Scooby-Doo and the Runaway Robot (Scooby-Doo Mysteries, 13)",2000,10,9,3,2000,0
james gelsey,"Scooby-Doo! and the Frankenstein Monster (Scooby-Doo Mysteries, 12)",2000,11,1.6,5,2000,0
james gelsey,"Scooby-Doo! and the Zombie's Treasure (Scooby-Doo Mysteries, 9)",2000,12,5,2,2000,0
james gelsey,"Scooby Doo! and the Spooky Strikeout (Scooby-Doo Mysteries, 10)",2000,13,0,2,2000,0
james gelsey,"Scooby-Doo! and the Groovy Ghost (Scooby-Doo Mysteries, 8)",2000,14,1,5,2000,0
james gelsey,"Scooby-Doo! and the Toy Store Terror (Scooby-Doo Mysteries, 16)",2001,15,5,2,2000,1
james gelsey,"Scooby-Doo and the Farmyard Fright (Scooby-Doo Mysteries, 17)",2001,16,0,2,2001,0
james gelsey,"Scooby-Doo and the Caveman Caper (Scooby-Doo Mysteries, 18)",2001,17,0,1,2001,0
james gelsey,"Scooby-Doo! and the Rowdy Rodeo (Scooby-Doo Mysteries, 19)",2001,18,2,4,2001,0
james gelsey,Scooby-Doo! and the Masked Magician (Scooby-Doo Mysteries),2001,19,3.3333333333333335,3,2001,0
james gelsey,"Scooby-Doo and the Vicious Viking (Scooby-Doo Mysteries, 21)",2002,20,2.5,2,2001,1
james gelsey,"Scooby-Doo! and the Karate Caper (Scooby-Doo Mysteries, 23)",2002,21,1.6666666666666667,3,2002,0
james gelsey,"Scooby-Doo and the Ghostly Gorilla (Scooby-Doo Mysteries, 20)",2002,22,5,1,2002,0
james gelsey,"Scooby-Doo! and the Headless Horseman (Scooby-Doo Mysteries, 25)",2002,23,0,3,2002,0
james gelsey,"Scooby-Doo and the Seashore Slimer (Scooby-Doo Mysteries, 22)",2002,24,0,1,2002,0
james gelsey,"Scooby-Doo and the Bowling Boogeyman (Scooby-Doo Mysteries, 24)",2002,25,0,1,2002,0
james gelsey,Scooby Doo And The Deep Sea Diver,2003,26,0,1,2002,1
james gelsey,Scooby-Doo! and the Sinister Sorcerer (Scooby-Doo Mysteries),2003,27,0,1,2003,0
james gelsey,Scooby-Doo and the Witch Doctor (Scooby-Doo Mysteries),2003,28,5,1,2003,0
james gelsey,Scooby-Doo and the Gruesome Goblin (Scooby-Doo Mysteries),2004,29,6,1,2003,1
james grady,Just a Shot Away,1987,2,4.5,2,1974,13
james grady,HARD BARGAINS,1987,3,0,1,1987,0
james grady,Steeltown,1989,4,0,1,1987,2
james grady,River of Darkness,1991,5,5,1,1989,2
james grady,River of Darkness,1992,6,1.6,5,1991,1
james grady,Thunder,1995,7,2.3333333333333335,3,1992,3
james grady,White Flame,1996,8,0,1,1995,1
james grady,White Flame: A Novel,1996,9,4,1,1996,0
james h. schmitz,Telzey Amberdon (Telzey Amberdon (Baen)),2000,2,5.333333333333333,3,1984,16
james h. schmitz,TNT : Telzey &amp; Trigger,2000,3,4.5,2,2000,0
james h. schmitz,The Witches of Karres (SF Collector's Edition),2000,4,8,1,2000,0
james h. schmitz,Agent of Vega &amp; Other Stories,2001,5,4.666666666666667,3,2000,1
james h. schmitz,Trigger &amp; Friends,2001,6,1.3333333333333333,3,2001,0
james h. schmitz,The Hub : Dangerous Territory,2001,7,8,1,2001,0
james h. schmitz,Eternal Frontier,2002,8,0,1,2001,1
james h. schmitz,The Witches of Karres,2004,9,7,1,2002,2
james halliday,Australia &amp; New Zealand Wine Companion: 2000,1999,2,5,1,1982,17
james j. rybacki,The Essential Guide to Prescription Drugs 2000 (Serial),1999,2,10,1,1996,3
james johnson,Which Dog for Me?,1992,2,0,1,1988,4
james kelman,"How Late It Was, How Late",1994,2,0,2,1992,2
james kelman,"How Late It Was, How Late",1994,3,0,1,1994,0
james kelman,"How Late It Was, How Late",1994,4,3.5,2,1994,0
james kelman,"How Late It Was, How Late",1996,5,0,7,1994,2
james kelman,Busted Scotch: Selected Stories,1997,6,4,1,1996,1
james kelman,Busted Scotch: Selected Stories,1998,7,0,1,1997,1
james kelman,The Good Times,1999,8,3,1,1998,1
james krã?â¼ss,Der Leuchtturm auf den Hummerklippen.,1999,2,8,1,1979,20
james l.  roberts,Daisy Miller and The Turn of the Screw (Cliffs Notes),1965,2,0,1,1965,0
james l.  roberts,Beckett's Waiting for Godot and Other Plays (Cliffs Notes),1980,3,0,1,1965,15
james l.  roberts,The Adventures of Tom Sawyer (Cliffs Notes),2000,4,6,1,1980,20
james lasdun,The Horned Man,2002,2,2.6666666666666665,3,1997,5
james lasdun,Die Jagd auf das Einhorn.,2002,3,8,1,2002,0
james lasdun,The Horned Man: A Novel,2003,4,1.6666666666666667,3,2002,1
james lee burke,The Lost Get-Back Boogie,1987,2,8,1,1982,5
james lee burke,HEAVEN'S PRISONERS (Dave Robicheaux Mysteries (Paperback)),1989,3,4.375,8,1987,2
james lee burke,Black Cherry Blues: A Dave Robicheaux Novel,1990,4,1.5833333333333333,36,1989,1
james lee burke,NEON RAIN : A Dave Robicheaux Novel,1992,5,2.4444444444444446,36,1990,2
james lee burke,A Stained White Radiance,1992,6,0,1,1992,0
james lee burke,In the Electric Mist With Confederate Dead,1993,7,0,1,1992,1
james lee burke,A Stained White Radiance,1993,8,1.6,25,1993,0
james lee burke,Dixie City Jam,1994,9,6.666666666666667,3,1993,1
james lee burke,Burning Angel: A Novel (Dave Robicheaux Mysteries (Hardcover)),1995,10,1.6666666666666667,9,1994,1
james lee burke,Burning Angel (Dave Robicheaux Mysteries (Audio)),1995,11,0,1,1995,0
james lee burke,Two for Texas,1995,12,5,3,1995,0
james lee burke,Lay Down My Sword and Shield: A Novel,1995,13,0,2,1995,0
james lee burke,To the Bright and Shining Sun: A Novel,1995,14,3.5,2,1995,0
james lee burke,Half of Paradise,1995,15,7,1,1995,0
james lee burke,Dixie City Jam,1995,16,2.4705882352941178,34,1995,0
james lee burke,The Lost Get Back Boogie,1995,17,0,3,1995,0
james lee burke,Cadillac Jukebox (Dave Robicheaux Mysteries (Hardcover)),1996,18,1.5,12,1995,1
james lee burke,Burning Angel (Dave Robicheaux Mysteries (Paperback)),1996,19,2.142857142857143,28,1996,0
james lee burke,HEAVEN'S PRISONERS (Dave Robicheaux Mysteries (Paperback)),1996,20,1.3,10,1996,0
james lee burke,The Lost Get-Back Boogie,1997,21,2.230769230769231,13,1996,1
james lee burke,Cadillac Jukebox (Dave Robicheaux Mysteries (Paperback)),1997,22,1.96875,32,1997,0
james lee burke,Cimarron Rose (Dave Robicheaux Mysteries (Hardcover)),1997,23,1.6666666666666667,3,1997,0
james lee burke,Half of Paradise,1998,24,2.2,10,1997,1
james lee burke,Sunset Limited,1998,25,3,7,1998,0
james lee burke,Cimarron Rose,1998,26,1.85,20,1998,0
james lee burke,Heartwood,1999,27,2.3333333333333335,6,1998,1
james lee burke,Heartwood,1999,28,0,2,1999,0
james lee burke,Sunset Limited (Dave Robicheaux Mysteries (Paperback)),1999,29,1.9189189189189189,37,1999,0
james lee burke,Lay Down My Sword and Shield,1999,30,1.25,4,1999,0
james lee burke,Heartwood (Random House Large Print),1999,31,9,1,1999,0
james lee burke,Purple Cane Road,2000,32,2.1052631578947367,19,1999,1
james lee burke,To the Bright and Shining Sun,2000,33,1.5,6,2000,0
james lee burke,Purple Cane Road (Dave Robicheaux Mysteries (Audio)),2000,34,4,3,2000,0
james lee burke,Purple Cane Road,2000,35,0,1,2000,0
james lee burke,The Convict and Other Stories,2000,36,0,3,2000,0
james lee burke,Two for Texas,2000,37,1.75,4,2000,0
james lee burke,Heartwood,2000,38,1.6666666666666667,24,2000,0
james lee burke,Bitterroot,2001,39,0,2,2000,1
james lee burke,Purple Cane Road,2001,40,2.8,30,2001,0
james lee burke,Bitterroot,2001,41,4.181818181818182,11,2001,0
james lee burke,Jolie Blon's Bounce : A Novel,2002,42,5.2105263157894735,19,2001,1
james lee burke,Jolie Blon's Bounce,2002,43,8,1,2002,0
james lee burke,Bitterroot,2002,44,3.7037037037037037,27,2002,0
james lee burke,The Neon Rain : A Dave Robicheaux Novel,2002,45,0,3,2002,0
james lee burke,Heaven's Prisoners,2002,46,0,1,2002,0
james lee burke,White Doves at Morning : A Novel,2002,47,3.1666666666666665,6,2002,0
james lee burke,Last Car to Elysian Fields: A Novel,2003,48,4.833333333333333,6,2002,1
james lee burke,Dans la brume Ã?Â©lectrique avec les morts confÃ?Â©dÃ?Â©rÃ?Â©s,2003,49,0,1,2003,0
james lee burke,Jolie Blon's Bounce,2003,50,2.2857142857142856,14,2003,0
james lee burke,"In the Moon of Red Ponies : A Novel (Burke, James Lee)",2004,51,8.5,2,2003,1
james lee burke,White Doves at Morning : A Novel,2004,52,0,2,2004,0
james lipton,Mirrors,1982,2,8,1,1977,5
james lipton,An Exaltation of Larks: The Ultimate Edition,1993,3,5,1,1982,11
james lipton,An Exaltation of Business and Finance,1993,4,7,1,1993,0
james long,Ferney,1999,2,8,3,1995,4
james long,Ferney,2000,3,2.5,2,1999,1
james long,Silence and Shadows,2002,4,7,2,2000,2
james m. cain,The Butterfly,1982,2,0,1,1978,4
james m. cain,Past All Dishonor (Arbor House library of contemporary Americana),1984,3,0,1,1982,2
james m. cain,The Five Great Novels of James M. Cain (Picador),1985,4,2.5,2,1984,1
james m. cain,Mildred Pierce (Vintage Crime),1989,5,10,1,1985,4
james m. cain,Double Indemnity (Vintage Crime/Black Lizard),1989,6,4.888888888888889,9,1989,0
james m. cain,The Postman Always Rings Twice (Vintage Crime/Black Lizard),1992,7,1.8,5,1989,3
james m. cain,Im Dunkel jener Nacht. Roman.,1999,8,0,1,1992,7
james m. cain,Faux en Ã?Â©criture,2003,9,8,1,1999,4
james m. cain,Assurance sur la mort,2003,10,0,1,2003,0
james magnuson,Open Season,1983,2,5,2,1980,3
james mccourt,Wayfaring at Waverly in Silver Lake,2002,2,0,1,1984,18
james mccourt,Mawrdew Czgowchwz (New York Review Books Classics),2002,3,4,1,2002,0
james mills,The Power,1990,2,0,1,1987,3
james mills,The Power,1992,3,0,1,1990,2
james mills,Haywire a Novel of Suspense,1995,4,1.6666666666666667,3,1992,3
james mills,Haywire,1996,5,0,2,1995,1
james mills,The Hearing,1998,6,0,2,1996,2
james mills,The Hearing,1999,7,2.5,2,1998,1
james p. blaylock,The Last Coin,1988,2,9,1,1983,5
james p. blaylock,Lord Kelvin's Machine,1992,3,7,1,1988,4
james p. blaylock,The Paper Grail,1992,4,0,1,1992,0
james p. blaylock,Night Relics,1996,5,0,1,1992,4
james p. blaylock,All the Bells on Earth,1997,6,0,2,1996,1
james p. blaylock,Winter Tides,1998,7,2,3,1997,1
james p. blaylock,The Rainy Season,2000,8,4.4,5,1998,2
james p. blaylock,Die Brunnenkinder.,2002,9,4,2,2000,2
james p. carse,Finite and Infinite Games,1994,2,4,2,1986,8
james p. carse,Breakfast at the Victory: The Mysticism of Ordinary Experience,1994,3,0,4,1994,0
james p. carse,"Breakfast at the Victory : Mysticism of Ordinary Experience, The",1995,4,3,5,1994,1
james p. carse,The Silence of God: Meditations on Prayer,1995,5,6,1,1995,0
james p. comer,Maggie's American Dream: The Life and Times of a Black Family,1989,2,0,1,1988,1
james purdy,Gertrude of Stony Island Avenue,1998,2,3,2,1988,10
james rachels,The Elements of Moral Philosophy,2002,2,7,1,1994,8
james raven,"Test of Wills (Dojo Rats, No 4)",1993,2,0,1,1993,0
james raven,Subzero (Adventures of Batman &amp; Robin),1997,3,0,1,1993,4
james robinson,"Shaman's Rain (Leave It to Chance, Book 1)",1999,2,0,1,1985,14
james robinson,Leave It To Chance Vol. 1: Shaman's Rain,2002,3,5.333333333333333,3,1999,3
james runcie,The Discovery of Chocolate,2002,2,4.333333333333333,3,2001,1
james runcie,The Colour of Heaven,2003,3,3.625,8,2002,1
james runcie,The Colour of Heaven,2004,4,7,1,2003,1
james smith,Almost Human,1990,2,0,1,1988,2
james smith,Rich Mullins: An Arrow Pointing to Heaven,2002,3,3.3333333333333335,3,1990,12
james stoddard,The False House,2000,2,0,1,1998,2
james strong,"The New Strong's exhaustive concordance of the Bible: With main concordance, appendix to the main concordance, key verse comparison chart, dictionary of the Hebrew Bible, dictionary of the Greek Testament",1984,2,0,1,1976,8
james strong,Strong's Exhaustive Concordance of the Bible,1986,3,9,1,1984,2
james strong,Strong's Exhaustive Concordance of the Bible,1988,4,2.5,2,1986,2
james strong,The New Strong's Exhaustive Concordance Of The Bible : Classic Edition,1990,5,8,1,1988,2
james van hise,Midnight Graffiti,1992,2,3.6923076923076925,13,1991,1
james van hise,Trek: The Printed Adventures,1993,3,0,1,1992,1
james van hise,The Unauthorized Trekker's Guide to the Next Generation and Deep Space Nine,1995,4,0,1,1993,2
james van hise,The Unauthorized History of Trek (Harper Prism),1995,5,3,3,1995,0
james van hise,Sci Fi TV: From the Twilight Zone to Deep Space Nine,1995,6,4,2,1995,0
james van hise,The Secrets Of Frank Herbert'S Dune,2000,7,4,1,1995,5
james w. huston,The Price of Power,1999,2,3,2,1998,1
james w. huston,Flash Point,2000,3,0,1,1999,1
james w. huston,Fallout,2001,4,0,1,2000,1
james w. huston,The Shadows of Power: A Novel,2002,5,7,1,2001,1
james w. huston,The Shadows of Power,2003,6,4.625,8,2002,1
james w. huston,Secret Justice,2004,7,8.5,2,2003,1
james weldon johnson,The Autobiography of an Ex-Colored Man (Penguin Twentieth Century Classics),1990,2,3.4444444444444446,9,1990,0
james weldon johnson,The Autobiography of an Ex-Coloured Man (American Century Series),1991,3,0,2,1990,1
james weldon johnson,The Autobiography of an Ex-Colored Man (Dover Thrift Editions),1995,4,1.5,6,1991,4
james west davidson,The Complete Wilderness Paddler,1983,2,0,1,1981,2
james west davidson,After the fact: The art of historical detecton,1986,3,0,1,1983,3
james west davidson,"Nation of Nations: A Narrative History of the American Republic, Volume I",1997,4,8,1,1986,11
jamie gilson,"Can't Catch Me, I'm the Gingerbread Man",1982,2,0,1,1981,1
jamie gilson,Thirteen Was To Sink A Sub,1983,3,0,2,1982,1
jamie gilson,Thirteen Ways to Sink a Sub,1983,4,0,2,1983,0
jamie gilson,"Hello, My Name Is Scrambled Eggs",1985,5,0,1,1983,2
jamie gilson,"Hobie Hanson, You're Weird",1987,6,0,1,1985,2
jamie gilson,THIRTEEN WAYS TO SINK A SUB (RACK SIZE),1989,7,0,1,1987,2
jamie gilson,CAN'T CATCH ME I'M THE GINGERBREAD MAN : CAN'T CATCH ME I'M THE GINGERBREAD MAN,1989,8,0,1,1989,0
jamie gilson,DOUBLE DOG DARE : DOUBLE DOG DARE,1989,9,2.3333333333333335,3,1989,0
jamie gilson,DO BANANAS CHEW GUM? : DO BANANAS CHEW GUM?,1989,10,0,1,1989,0
jamie gilson,"HOBIE HANSON, GREATEST HERO OF THE MALL : HOBIE HANSON, GREATEST HERO OF THE MALL",1990,11,8,1,1989,1
jamie gilson,"Hello, My Name Is Scrambled Eggs",1991,12,5,1,1990,1
jamie gilson,ITCHY RICHARD : ITCHY RICHARD,1993,13,7,1,1991,2
jamie gilson,Wagon Train 911,1996,14,4,6,1993,3
jamie gilson,"Dial Leroi Rupert, Dj",1999,15,0,1,1996,3
jamie james,Andrew and Joey,2003,2,5,2,2002,1
jamie jaworski,Java 1.1 Developer's Guide (Sams.Net Developer's Guide),1997,2,0,1,1996,1
jamie miller,The Magic of Christmas Miracles : An All-New Collection Of Inspiring True Stories,1998,2,0,1,1997,1
jamie miller,A Gift of Miracles : Magical True Stories To Touch Your Family's Heart,1999,3,8,1,1998,1
jamila gavin,Our Favourite Stories,1997,2,7,1,1996,1
jamila gavin,The Track of the Wind,1998,3,0,1,1997,1
jamila gavin,Forbidden Memories (Mammoth Reads),1998,4,0,1,1998,0
jamila gavin,Coram Boy (Contents),2000,5,3.2222222222222223,9,1998,2
jamila gavin,Coram Boy,2000,6,0,1,2000,0
jamila gavin,Fine Feathered Friend (Yellow Bananas),2002,7,0,1,2000,2
jan cox speas,Growing Season,1979,2,0,2,1978,1
jan cox speas,"My Love, My Enemy",1984,3,0,1,1979,5
jan kerouac,Trainsong,1989,2,0,1,1988,1
jan king,Husbands from Hell,1991,2,2,2,1990,1
jan king,Hormones from Hell II: The Misery Continues...,1994,3,5,2,1991,3
jan king,50 - Deal with It,1998,4,0,1,1994,4
jan king,It'S A Girl Thing,2000,5,0,3,1998,2
jan kuhlbrodt,Platon und die SpÃ?Â¼lmaschine. Ein philosophisches VergnÃ?Â¼gen.,2002,2,0,2,2001,1
jan l. waldron,In the Country of Men: My Travels,1998,2,0,1,1995,3
jan marino,Like Some Kind of Hero,1993,2,3,2,1991,2
jan marino,For the Love of Pete: A Novel,1993,3,0,2,1993,0
jan marino,For the Love of Pete (An Avon Camelot Book),1994,4,0,1,1993,1
jan slepian,The Hungry Thing Returns,1990,2,0,1,1982,8
jan slepian,The Broccoli Tapes,1991,3,0.6,5,1990,1
jan slepian,Risk N' Roses,1992,4,3.5,2,1991,1
jan slepian,Back to Before,1993,5,0,1,1992,1
jan slepian,The Hungry Thing Returns,1993,6,0,1,1993,0
jan slepian,The Mind Reader,1997,7,0,1,1993,4
jan slepian,The Hungry Thing (Hungry Thing),2001,8,0,1,1997,4
jan wong,Red China Blues: My Long March from Mao to Now,1997,2,2.3333333333333335,3,1996,1
jana g. oliver,The Circle of the Swan,2001,2,7,1,2001,0
jana g. oliver,The Summoning Stone (The Dragonfire Fantasy Series),2002,3,0,1,2001,1
jane alison,The Love-Artist : A Novel (Bestselling Backlist),2002,2,0,3,2001,1
jane b. moncure,Word Bird's Dinosaur Day (School Day Books),1990,2,3.5,2,1988,2
jane barry,Casting,1993,2,0,1,1988,5
jane barry,Hungry,1994,3,0,2,1993,1
jane bell kiester,The Chortling Bard: Caught'ya Grammar with a Giggle for High Schools,1998,2,10,1,1990,8
jane butel,"Finger Lickin, Rib Stickin, Great Tasting Barbecue",1982,2,10,1,1982,0
jane butel,Woman's Day Book of New Mexican Cooking,1984,3,0,1,1982,2
jane butel,Jane Butel's Southwestern Kitchen,1994,4,7,1,1984,10
jane carpineto,On Call: Three Doctors on the Front Lines,1994,2,0,1,1993,1
jane carpineto,On Call: Three Doctors on the Front Lines,1995,3,0,1,1994,1
jane carpineto,On the Vineyard : A Year in the Life of an Island,1999,4,5,1,1995,4
jane dunn,"Elizabeth and Mary : Cousins, Rivals, Queens",2004,2,7,1,1995,9
jane dunn,"Elizabeth and Mary : Cousins, Rivals, Queens",2004,3,6,3,2004,0
jane f. gardner,The Roman Household: A Sourcebook,1991,2,8,1,1991,0
jane garton,Happy: 100 Tips to Feel Great (100 Tips Series),2003,2,0,1,1998,5
jane greenoff,Country Cross Stitch: 55 Charts With More Than 100 Designs (Reader's Digest),1997,2,0,1,1988,9
jane greenoff,The Cross Stitcher's Bible (Crafts),2000,3,3.8,5,1997,3
jane hale,Heartland,1999,2,10,1,1997,2
jane hale,Foreverland,2001,3,10,1,1999,2
jane jerrard,The ugly duckling (Fairy tale treasury),1993,2,5,2,1992,1
jane jerrard,5-Minute Fairy Tales,2001,3,0,1,1993,8
jane jerrard,"Jack and the Beanstalk (Fairy Tale Treasury, Volume 1)",2003,4,0,1,2001,2
jane jerrard,"Little Red Riding Hood (Fairy Tale Treasury, Volume 1)",2003,5,0,2,2003,0
jane johnston,Pray For Ricky Foster,1991,2,0,2,1988,3
jane kenyon,Otherwise : New and Selected Poems,1996,2,6.666666666666667,3,1993,3
jane lahr,The Celtic Quest In Art And Literature,2000,2,10,2,1982,18
jane m. healy,FAILURE TO CONNECT: How Computers Affect Our Children's Minds -- and What We Can Do About It,1999,2,0,1,1999,0
jane mccafferty,One Heart : A Novel,2000,2,3.2,5,1999,1
jane mccafferty,Thank You for the Music : Stories,2004,3,0,2,2000,4
jane middelton-moz,Bullies: From The Playground to the Boardroom,2002,2,0,1,1986,16
jane pettigrew,Tee (Evergreens),1998,2,8,1,1997,1
jane pettigrew,A Social History of Tea,2002,3,10,1,1998,4
jane pratt,Beyond Beauty,1997,2,4,2,1995,2
jane resh thomas,"COMEBACK DOG, THE",1983,2,0,1,1981,2
jane resh thomas,The Princess in the Pigpen,1989,3,0,1,1983,6
jane resh thomas,Fox in a Trap,1990,4,0,1,1989,1
jane resh thomas,The Princess in the Pigpen (An Avon Camelot Book),1993,5,0,1,1990,3
jane waterhouse,Playing for Keeps!!,1992,2,0,1,1987,5
jane waterhouse,Graven Images,1997,3,0.6666666666666666,3,1992,5
jane waterhouse,Dead Letter,1998,4,0,2,1997,1
jane waterhouse,Shadow Walk (Prime Crime Mysteries),1999,5,0,1,1998,1
jane waterhouse,Dead Letter,2000,6,3,5,1999,1
jane waterhouse,Schattenpfade.,2000,7,0,1,2000,0
jane wood,Josey Rose : A Novel,1998,2,0,2,1973,25
janet campbell,Walt Disney's Mickey Mouse's book of cars and trucks (A First little golden book),1993,2,0,1,1991,2
janet campbell,Walt Disney's: Winnie the Pooh and the Honey Tree,1993,3,3.3333333333333335,3,1993,0
janet dailey,One of the Boys,1980,2,0,1,1980,0
janet dailey,"The Thawing of Mara (Harlequin Presents, #349)",1980,3,0,1,1980,0
janet dailey,"Dakota Dreamin' (Harlequin Presents, #445)",1981,4,0,1,1980,1
janet dailey,"The Hostage Bride (Silhouette Romance, #82)",1981,5,0,1,1981,0
janet dailey,The Hostage Bride,1981,6,3.5,2,1981,0
janet dailey,This Calder Sky,1981,7,0,3,1981,0
janet dailey,"The Second Time (Silhouette Romance, #177)",1982,8,0,3,1981,1
janet dailey,Wildcatter's Woman,1982,9,0,1,1982,0
janet dailey,THIS CALDER SKY,1982,10,0,2,1982,0
janet dailey,Northern Magic (Harlequin Presents),1982,11,0,2,1982,0
janet dailey,With a Little Luck (Harlequin Presents),1982,12,0,1,1982,0
janet dailey,Terms of Surrender (Silhouette Special Edition),1982,13,0,1,1982,0
janet dailey,This Calder Range,1982,14,2.3333333333333335,3,1982,0
janet dailey,THIS CALDER SKY,1982,15,0,2,1982,0
janet dailey,THIS CALDER RANGE,1982,16,0,2,1982,0
janet dailey,CALDER BORN BREDTR,1983,17,0,2,1982,1
janet dailey,TOUCH THE WIND,1983,18,0,1,1983,0
janet dailey,STAND CALDR MN TRD,1983,19,0,2,1983,0
janet dailey,ROGUE,1983,20,0,1,1983,0
janet dailey,Western Man,1983,21,7,1,1983,0
janet dailey,The Best Way to Lose,1983,22,0,1,1983,0
janet dailey,"Western Man (Silhouette Romance, #231)",1983,23,0,1,1983,0
janet dailey,STAND CALDER MAN,1983,24,1.6666666666666667,6,1983,0
janet dailey,"Separate Cabins (Silhouette Romance, #213)",1983,25,0,1,1983,0
janet dailey,"Silver Wings, Santiago Blue",1984,26,10,1,1983,1
janet dailey,HOSTAGE BRIDE   PB,1984,27,0,2,1984,0
janet dailey,The Glory Game,1985,28,0,2,1984,1
janet dailey,MISTLETOE HOLLY,1985,29,2,5,1985,0
janet dailey,SILVER WNG SAN BLU,1985,30,0,7,1985,0
janet dailey,Glory Game,1985,31,0,2,1985,0
janet dailey,PRIDE HANNAH WADTR,1985,32,5,2,1985,0
janet dailey,PRIDE HANNAH WADE,1985,33,1.8333333333333333,6,1985,0
janet dailey,SEPARATE CABINS,1985,34,0,1,1985,0
janet dailey,GLORY GAME,1986,35,0.2727272727272727,11,1985,1
janet dailey,Southern Nights,1986,36,0,2,1986,0
janet dailey,After The Storm,1986,37,0,3,1986,0
janet dailey,Fire And Ice,1986,38,0,2,1986,0
janet dailey,NIGHTWAY,1986,39,9,1,1986,0
janet dailey,Difficult Decisions,1986,40,0,2,1986,0
janet dailey,Sonora Sundown,1986,41,0,1,1986,0
janet dailey,"Silver Wings, Santiago Blue",1986,42,1.6666666666666667,3,1986,0
janet dailey,Leftover Love,1986,43,0,1,1986,0
janet dailey,Kona Winds,1986,44,0,2,1986,0
janet dailey,The Great Alone,1986,45,0,1,1986,0
janet dailey,Matchmakers,1986,46,0,2,1986,0
janet dailey,RIDE THUNDER,1986,47,3,2,1986,0
janet dailey,Western Man,1986,48,0,2,1986,0
janet dailey,TOUCH THE WIND,1986,49,0,1,1986,0
janet dailey,Six White Horses (Janet Dailey Americana Series),1987,50,10,1,1986,1
janet dailey,GREAT ALONE,1987,51,0.8,10,1987,0
janet dailey,Widow And The Wa,1987,52,0,1,1987,0
janet dailey,Heart Of Stone (Janet Dailey Americana),1987,53,0,1,1987,0
janet dailey,That Carolina Summer,1987,54,5,2,1987,0
janet dailey,Bluegrass King (Bluegrass King - Kentucky),1987,55,0,2,1987,0
janet dailey,Giant Of Mesabi,1987,56,0,1,1987,0
janet dailey,To Tell The Truth (Janet Dailey Americana Series),1987,57,0,1,1987,0
janet dailey,Strange Bedfellow (Janet Dailey Americana),1987,58,10,1,1987,0
janet dailey,Heiress,1987,59,0,1,1987,0
janet dailey,Lord Of The High Lon,1987,60,10,1,1987,0
janet dailey,Bride Of The Delta Q,1987,61,0,2,1987,0
janet dailey,Savage Land,1988,62,4.25,4,1987,1
janet dailey,With Litle Luck Wi,1988,63,0,1,1988,0
janet dailey,Dakota Dreaming (Janet Dailey American Series),1988,64,10,1,1988,0
janet dailey,Thawing Of Mara,1988,65,0,1,1988,0
janet dailey,FOXFIRE LIGHT,1988,66,0,1,1988,0
janet dailey,Travelling Kind (Janet Dailey Americana),1988,67,0,1,1988,0
janet dailey,Indy Man,1988,68,0,2,1988,0
janet dailey,Matchmakers,1988,69,0,2,1988,0
janet dailey,Wild &amp; Wonderfl Wv,1988,70,0,1,1988,0
janet dailey,Bride Of The Del,1988,71,0,1,1988,0
janet dailey,One Of The Boys (Janet Dailey Americana),1988,72,0,2,1988,0
janet dailey,Darling Jenny   Wy (Janet Dailey Americana),1988,73,0,2,1988,0
janet dailey,Mating Season,1988,74,0,2,1988,0
janet dailey,Land Of Enchantment (Americana),1988,75,0,1,1988,0
janet dailey,Ride the Thunder,1988,76,0,1,1988,0
janet dailey,Homeplace,1988,77,0,2,1988,0
janet dailey,Rivals,1988,78,0,2,1988,0
janet dailey,Sentimental Journey,1988,79,2.5,4,1988,0
janet dailey,Kona Winds (Janet Dailey Americana; Hawaii),1988,80,0,3,1988,0
janet dailey,STANDS A CALDER MAN,1988,81,0,1,1988,0
janet dailey,"SILVER WINGS, SANTIAGO BLUE",1988,82,0,1,1988,0
janet dailey,Tide Water Lover,1988,83,10,1,1988,0
janet dailey,Lyon'S Share,1988,84,0,1,1988,0
janet dailey,For Mike'S Sake Wa,1988,85,7,1,1988,0
janet dailey,Southern Nights,1988,86,0,1,1988,0
janet dailey,SEPARATE CABINS,1989,87,0,1,1988,1
janet dailey,FOR THE LOVE OF GOD,1989,88,0,2,1989,0
janet dailey,Master Fiddler,1989,89,0,1,1989,0
janet dailey,Something Extra,1989,90,0,2,1989,0
janet dailey,NIGHTWAY,1989,91,0,4,1989,0
janet dailey,Masquerade,1990,92,0,4,1989,1
janet dailey,MISTLETOE AND HOLLY (Silhouette Romance),1990,93,0,1,1990,0
janet dailey,Terms of Surrender,1990,94,0,1,1990,0
janet dailey,No Quarter Asked,1990,95,2,3,1990,0
janet dailey,Rivals,1990,96,0,13,1990,0
janet dailey,For Bitter Or Worse,1990,97,0,1,1990,0
janet dailey,Fiesta San Antonio,1990,98,0,2,1990,0
janet dailey,After The Storm   (Colorado) (Janet Dailet Americana),1991,99,0,1,1990,1
janet dailey,"Difficult Decision - (Connecticut) - Janet Dailey Americana (J.D. Americana, No7)",1991,100,0,1,1991,0
janet dailey,Mistletoe and Holly/Sweet Sea Spirit (Christmas Magic),1991,101,5,2,1991,0
janet dailey,"Bride Of The Delta Queen #18 Louisiana (Janet Dailey Americana, No 18)",1991,102,0,1,1991,0
janet dailey,"Southern Nights (Florida) (Janet Dailey Americana, No 9)",1991,103,0,1,1991,0
janet dailey,"Summer Mahogany (Janet Daily Americana, No. 19)",1991,104,0,1,1991,0
janet dailey,The Lancaster Men (Promo Series : No 190),1991,105,0,2,1991,0
janet dailey,The Second Time,1991,106,5,1,1991,0
janet dailey,"Lyon'S Share  (Illinois) (Janet Dailey Americana, No 13)",1991,107,0,1,1991,0
janet dailey,"Bed Of Grass (Janet Dailey Americana, No 20)",1991,108,0,1,1991,0
janet dailey,Travelling Kind (Idaho) (Janet Dailey Americana),1991,109,0,2,1991,0
janet dailey,"Bluegrass King #17 Kentucky (Janet Dailey Americana, No 17)",1991,110,0,1,1991,0
janet dailey,"Giant Of Mesabi (Janet Daily Americana, No. 23/Minnesota)",1991,111,0,2,1991,0
janet dailey,Homeplace   (Iowa) (Janet Dailey Americana No. 15),1991,112,0,1,1991,0
janet dailey,"Matchmakers - (Delaware) - Janet Dailey Americana (J.D. Americana, No 8)",1991,113,0,1,1991,0
janet dailey,The Travelling Kind/Idaho,1991,114,0,3,1991,0
janet dailey,"Leftover Love (Special Edition, No 150)",1991,115,0,1,1991,0
janet dailey,For the Love of God (Promo Series : No 191),1991,116,0,1,1991,0
janet dailey,"Night Of The Cotillion (Georgia) (Janet Dailey Americana Series, No 10)",1991,117,0,1,1991,0
janet dailey,"Tradition Of Pride (Janet Dailey Americana, No. 24/Mississippi)",1991,118,0,1,1991,0
janet dailey,THIS CALDER SKY,1991,119,0,1,1991,0
janet dailey,Ride the Thunder,1991,120,0,1,1991,0
janet dailey,Aspen Gold,1991,121,2,6,1991,0
janet dailey,"Indy Man  (Indiana) (Janet Dailey Americana, No 14)",1991,122,0,1,1991,0
janet dailey,Valley Of The Vapours  (Arkansas) (Janet Dailey Americana Arkansas),1991,123,0,2,1991,0
janet dailey,Sweet Promise,1991,124,9,1,1991,0
janet dailey,Sonora Sundown  (Arizona),1991,125,0,2,1991,0
janet dailey,Fire And Ice  (California) (Americana California),1991,126,0,1,1991,0
janet dailey,Northern Magic  (Alaska) (Janet Dailey Americana Alaska),1991,127,0,1,1991,0
janet dailey,"Enemy In Camp (Janet Dailey Americana, No. 22)",1991,128,0,1,1991,0
janet dailey,Dangerous Masquerade - Alabama,1991,129,0,1,1991,0
janet dailey,"Mating Season  (Kansas) (Janet Dailey Americana, No. 16)",1991,130,0,1,1991,0
janet dailey,"Kona Winds (Hawaii) (Janet Dailey Americana Series, No 11)",1991,131,3,3,1991,0
janet dailey,Masquerade,1991,132,0,12,1991,0
janet dailey,Aspen Gold,1991,133,0,1,1991,0
janet dailey,"That Boston Man (Janet Dailey Americana, No. 21)",1991,134,0,1,1991,0
janet dailey,"Big Sky Country (Janet Daily Americana, No. 26)",1992,135,0,2,1991,1
janet dailey,"Thawing Of Mara #38 (Janet Dailey Americana, No 38)",1992,136,0,1,1992,0
janet dailey,"For Mike'S Sake #47 (J.D. Americana, No 47)",1992,137,0,1,1992,0
janet dailey,"Strange Bedfellow #39 (Janet Dailey Americana, No 39)",1992,138,0,1,1992,0
janet dailey,Lord Of The High Lonesome #34 (Janet Dailey Americana),1992,139,0,1,1992,0
janet dailey,"Six White Horses (Janet Dailey Americana : Oklahoma, No 36)",1992,140,0,1,1992,0
janet dailey,"Land Of Enchantment #31 (Janet Daily Americana, No 31)",1992,141,2.6666666666666665,3,1992,0
janet dailey,"Low Country Liar #40 (Janet Dailey Americana, No 40)",1992,142,0,1,1992,0
janet dailey,"Sentimental Journey #42 (Janet Dailey Americana, No 42)",1992,143,0,1,1992,0
janet dailey,"Widow And The Wastrel (Janet Dailey Americana : Ohio, No 35)",1992,144,2.3333333333333335,3,1992,0
janet dailey,"Wild And Wonderful (J.D. Americana, No 48)",1992,145,0,1,1992,0
janet dailey,"Green Mountain Man 45 (Janet Dailey Americana, No 45)",1992,146,0,1,1992,0
janet dailey,Land Called Desert #44 (J. D. Americana No. 44),1992,147,0,1,1992,0
janet dailey,"Boss Man From Ogallala # 52 (Harlequin Americana, No 89877)",1992,148,0,1,1992,0
janet dailey,Tidewater Lover 46 (Janet Dailey Americana No 46),1992,149,0,1,1992,0
janet dailey,"Show Me #25 (Janet Daily Americana, No 25)",1992,150,0,2,1992,0
janet dailey,Aspen Gold,1992,151,0.3888888888888889,18,1992,0
janet dailey,Tangled Vines,1992,152,2.4615384615384617,13,1992,0
janet dailey,Dakota Dreaming #41 (Janet Daily Americana No 41),1992,153,0,1,1992,0
janet dailey,"Reilly'S Woman # 53 (Harlequin Americana, No 89878)",1992,154,0,1,1992,0
janet dailey,"To Tell The Truth  #37 (Janet Dailey Americana, No 37)",1992,155,0,1,1992,0
janet dailey,That Carolina Summer #33 (Janet Dailey Americana),1992,156,0,1,1992,0
janet dailey,Heiress,1992,157,0,14,1992,0
janet dailey,Tangled Vines,1993,158,1.8076923076923077,26,1992,1
janet dailey,"With A Little Luck #49 (Janet Dailey Americana, No. 49)",1993,159,0,1,1993,0
janet dailey,The Rogue : The Real Team,1993,160,0,3,1993,0
janet dailey,TERMS OF SURRENDER : TERMS OF SURRENDER,1993,161,0,1,1993,0
janet dailey,Mistletoe and Holly (Holiday Classics),1993,162,1.875,8,1993,0
janet dailey,Nightway,1993,163,2.6666666666666665,3,1993,0
janet dailey,Darling Jenny #50 (Janet Dailey Americana No 50),1993,164,0,1,1993,0
janet dailey,"Silver Wings, Santiago Blue",1994,165,0,2,1993,1
janet dailey,FOR THE LOVE OF GOD : FOR THE LOVE OF GOD,1994,166,8,1,1994,0
janet dailey,The Proud and the Free,1994,167,3.5,2,1994,0
janet dailey,The Proud and the Free,1994,168,0,6,1994,0
janet dailey,Touch the Wind,1994,169,0,3,1994,0
janet dailey,Santa'S Little Helpers,1995,170,0.7272727272727273,11,1994,1
janet dailey,"Marry Me, Cowboy (4 Novels in 1)",1995,171,1.6666666666666667,9,1995,0
janet dailey,The Proud and the Free,1995,172,1.4615384615384615,13,1995,0
janet dailey,Legacies,1995,173,0,4,1995,0
janet dailey,Flower Girls,1996,174,1.5,4,1995,1
janet dailey,Notorious,1996,175,2,10,1996,0
janet dailey,Legacies,1996,176,0,4,1996,0
janet dailey,Sweet Promise,1996,177,0,3,1996,0
janet dailey,A Spring Bouquet: Castles in the Sand/ The Marrying Kind/ Hasten Down the Wind/ Forbidden Affections,1996,178,2.0588235294117645,17,1996,0
janet dailey,365 Ways to Make Love,1996,179,4,2,1996,0
janet dailey,Homecoming,1997,180,0,2,1996,1
janet dailey,Flower Girls,1997,181,0,1,1997,0
janet dailey,Summer Lovers,1997,182,0,2,1997,0
janet dailey,Homecoming,1997,183,4,2,1997,0
janet dailey,Illusions,1997,184,0,5,1997,0
janet dailey,Notorious,1997,185,1.2727272727272727,11,1997,0
janet dailey,Illusions : A Novel,1999,186,2.3076923076923075,13,1997,2
janet dailey,Valley of the Vapours (Janet Dailey Americana),1999,187,7,1,1999,0
janet dailey,Show Me (Janet Dailey Americana),1999,188,0,2,1999,0
janet dailey,Lord of the High Lonesome (Americana),1999,189,0,1,1999,0
janet dailey,Six White Horses (Janet Dailey Americana),1999,190,0,1,1999,0
janet dailey,This Calder Sky (This Calder Sky),1999,191,0,4,1999,0
janet dailey,One of the Boys (Janet Dailey Americana),1999,192,0,1,1999,0
janet dailey,Stands A Calder Man (Stands a Calder Man),1999,193,0,1,1999,0
janet dailey,Heart of Stone (Janet Dailey Americana),1999,194,0,1,1999,0
janet dailey,This Calder Range Volume 1,1999,195,0,5,1999,0
janet dailey,"Calder Born, Calder Bred",1999,196,0,8,1999,0
janet dailey,Calder Pride,2000,197,1.5185185185185186,27,1999,1
janet dailey,Heiress,2000,198,0,1,2000,0
janet dailey,A Spring Bouquet,2000,199,2.142857142857143,7,2000,0
janet dailey,A Capital Holiday (Zebra Book.),2001,200,1.588235294117647,17,2000,1
janet dailey,Scrooge Wore Spurs,2002,201,1.2058823529411764,34,2001,1
janet dailey,Can't Cay Goodbye,2002,202,0,1,2002,0
janet dailey,The Only Thing Better Than Chocolate,2002,203,0.7,10,2002,0
janet dailey,Green Calder Grass,2002,204,0,1,2002,0
janet dailey,Maybe This Christmas,2003,205,1.7307692307692308,26,2002,1
janet dailey,Green Calder Grass,2003,206,0.5294117647058824,17,2003,0
janet dailey,The Proud and the Free,2003,207,0,1,2003,0
janet dailey,"Calder Born, Calder Bred",2003,208,0,1,2003,0
janet dailey,Shifting Calder Wind,2003,209,8,1,2003,0
janet dailey,Western Man and Leftover Love,2004,210,8,1,2003,1
janet dailey,"Calder Promise (Dailey, Janet)",2004,211,5.333333333333333,3,2004,0
janet dailey,Shifting Calder Wind,2004,212,0,1,2004,0
janet evanovich,"Ivan Takes a Wife (Loveswept, No 343)",1989,2,1.5,4,1988,1
janet evanovich,"Back to the Bedroom (Loveswept, No 362)",1989,3,0,1,1989,0
janet evanovich,"Smitten (Loveswept, No 392)",1990,4,0,1,1989,1
janet evanovich,"Naughty Neighbor (Loveswept, No 537)",1992,5,0,1,1990,2
janet evanovich,ONE FOR THE MONEY : A Stephanie Plum Novel,1994,6,5.391304347826087,23,1992,2
janet evanovich,One for the Money (Stephanie Plum Novels (Paperback)),1995,7,3.656357388316151,291,1994,1
janet evanovich,Two for the Dough,1996,8,3.4644194756554305,267,1995,1
janet evanovich,Two for the Dough (Stephanie Plum Novels (Hardcover)),1996,9,3.6538461538461537,26,1996,0
janet evanovich,Einmal ist keinmal.,1997,10,3.6666666666666665,9,1996,1
janet evanovich,THREE TO GET DEADLY: A STEPHANIE PLUM NOVEL CASSETTE : A Stephanie Plum Novel (Stephanie Plum Novels (Audio)),1997,11,0,2,1997,0
janet evanovich,THREE TO GET DEADLY : A Stephanie Plum Novel,1997,12,3.7666666666666666,30,1997,0
janet evanovich,Three To Get Deadly : A Stephanie Plum Novel (A Stephanie Plum Novel),1998,13,3.4598214285714284,224,1997,1
janet evanovich,Two for the Dough (Stephanie Plum Novels (Hardcover)),1998,14,5,1,1998,0
janet evanovich,Four to Score (A Stephanie Plum Novel),1998,15,4.055555555555555,18,1998,0
janet evanovich,Four To Score (A Stephanie Plum Novel),1999,16,3.7244444444444444,225,1998,1
janet evanovich,Zweimal ist einmal zuviel.,1999,17,5,6,1999,0
janet evanovich,High Five (A Stephanie Plum Novel),1999,18,4.444444444444445,27,1999,0
janet evanovich,PSV Two for the Dough : A Stephanie Plum Novel (Stephanie Plum Novels (Paperback)),1999,19,9,1,1999,0
janet evanovich,Deux fois n'est pas coutume,2000,20,0,1,1999,1
janet evanovich,Einmal ist keinmal. Sonderausgabe.,2000,21,0,1,2000,0
janet evanovich,High Five (A Stephanie Plum Novel),2000,22,3.5323383084577116,201,2000,0
janet evanovich,"Eins, zwei, drei und du bist frei.",2000,23,3.625,8,2000,0
janet evanovich,Hot Six (Thorndike Press Large Print Core Series),2000,24,0,2,2000,0
janet evanovich,Vier Morde und ein Hochzeitsfest.,2000,25,4.833333333333333,6,2000,0
janet evanovich,Aller guten Dinge sind vier.,2000,26,4.777777777777778,9,2000,0
janet evanovich,Psv One For The Money Cs : A Stephanie Plum Novel,2000,27,0,1,2000,0
janet evanovich,Hot Six (A Stephanie Plum Novel),2000,28,4.065217391304348,46,2000,0
janet evanovich,Hot Six : A Stephanie Plum Novel (A Stephanie Plum Novel),2001,29,3.06,200,2000,1
janet evanovich,Seven-Up (Random House Large Print),2001,30,10,1,2001,0
janet evanovich,Seven Up (A Stephanie Plum Novel),2001,31,4.493333333333333,75,2001,0
janet evanovich,"Three Plums In One : One for the Money, Two for the Dough, Three to Get Deadly",2001,32,5.214285714285714,14,2001,0
janet evanovich,TÃ?Â¶dliche Versuchung.,2001,33,0,6,2001,0
janet evanovich,Seven Up,2001,34,0,1,2001,0
janet evanovich,Seven Up (A Stephanie Plum Novel),2002,35,3.665024630541872,203,2001,1
janet evanovich,Seven Up : International Edition,2002,36,2.6666666666666665,3,2002,0
janet evanovich,Hard Eight : A Stephanie Plum Novel (A Stephanie Plum Novel),2002,37,9,1,2002,0
janet evanovich,Hard Eight,2002,38,10,1,2002,0
janet evanovich,Full House,2002,39,4,1,2002,0
janet evanovich,Hard Eight : A Stephanie Plum Novel (A Stephanie Plum Novel),2002,40,8,1,2002,0
janet evanovich,Full House (Janet Evanovich's Full Series),2002,41,3.0428015564202333,257,2002,0
janet evanovich,Quartre Ou Double,2002,42,9,1,2002,0
janet evanovich,Visions of Sugar Plums (A Stephanie Plum Novel),2002,43,9,1,2002,0
janet evanovich,A Trilogy of Janet Evanovich: Four to Score/High Five/Hot Six,2002,44,0,2,2002,0
janet evanovich,Full House,2002,45,7,2,2002,0
janet evanovich,Hard Eight : A Stephanie Plum Novel (A Stephanie Plum Novel),2002,46,4.1923076923076925,104,2002,0
janet evanovich,Hard Eight : A Stephanie Plum Novel (A Stephanie Plum Novel),2002,47,0,1,2002,0
janet evanovich,Visions of Sugar Plums,2002,48,4.378947368421053,95,2002,0
janet evanovich,Visions of Sugar Plums (A Stephanie Plum Novel),2002,49,2,2,2002,0
janet evanovich,Full Speed (Random House Large Print),2003,50,0,1,2002,1
janet evanovich,To the Nines: A Stephanie Plum Novel,2003,51,3.9365079365079363,126,2003,0
janet evanovich,To the Nines (A Stephanie Plum Novel),2003,52,4.5,2,2003,0
janet evanovich,Full Tilt,2003,53,7,1,2003,0
janet evanovich,Full Speed (Janet Evanovich's Full Series),2003,54,3.011111111111111,90,2003,0
janet evanovich,Full Tilt (Janet Evanovich's Full Series),2003,55,0,2,2003,0
janet evanovich,TÃ?Â¶dliche Versuchung.,2003,56,9,1,2003,0
janet evanovich,Full Tilt (Janet Evanovich's Full Series),2003,57,2.189542483660131,153,2003,0
janet evanovich,One for the Money (A Stephanie Plum Novel),2003,58,4.02112676056338,142,2003,0
janet evanovich,Hard Eight : A Stephanie Plum Novel (A Stephanie Plum Novel),2003,59,3.5555555555555554,162,2003,0
janet evanovich,Cinq Ã?Â  sexe,2003,60,3,2,2003,0
janet evanovich,Janet Evanovich CD Box Set,2003,61,9.5,2,2003,0
janet evanovich,Ten Big Ones: A Stephanie Plum Novel,2004,62,2.9272727272727272,55,2003,1
janet evanovich,The Rocky Road to Romance,2004,63,8,1,2004,0
janet evanovich,Full Blast (Janet Evanovich's Full Series),2004,64,3.7096774193548385,62,2004,0
janet evanovich,Visions of Sugar Plums: A Stephanie Plum Holiday Novel,2004,65,2.9583333333333335,96,2004,0
janet evanovich,To the Nines (A Stephanie Plum Novel),2004,66,3.2954545454545454,44,2004,0
janet groene,Living Aboard Your Rv: A Guide to the Fulltime Life on Wheels,1993,2,0,3,1980,13
janet groene,Day Trips from Orlando: Getaways Approximately Two Hours Away,2002,3,10,1,1993,9
janet holm mchenry,"Prayerwalk: Becoming a Woman of Prayer, Strength, and Discipline",2001,2,3,3,1994,7
janet holm mchenry,Daily PrayerWalk: Meditations for a Deeper Prayer Life,2002,3,0,1,2001,1
janet louise roberts,Island of Desire,1977,2,0,2,1972,5
janet louise roberts,Golden Lotus,1982,3,0,2,1977,5
janet lowe,Bill Gates Speaks: Insight from the World's Greatest Entrepreneur,1998,2,5.666666666666667,3,1995,3
janet moursund,"Process of Counseling and Therapy, The",1992,2,0,1,1990,2
janet perlman,"Cinderella Penguin, Or, the Little Glass Flipper (Picture Puffins)",1995,2,0,1,1994,1
janet perlman,The Emperor Penguin's New Clothes (Picture Puffins),1997,3,0,1,1995,2
janet sue terry,Possibilities,2002,2,10,2,2002,0
janet tashjian,Multiple Choice,2001,2,0,1,1999,2
janet tashjian,The Gospel According to Larry,2001,3,0,1,2001,0
janet tashjian,The Gospel According to Larry (Readers Circle),2003,4,5.2,5,2001,2
janet tashjian,Fault Line,2003,5,0,1,2003,0
janice carter,"The Real Allie Newman (Harlequin Superromance, 1079)",2002,2,3.6,5,1987,15
janice carter,"The Second Family  (You,Me &amp; The Kids)",2003,3,2.6666666666666665,6,2002,1
janice carter,"Past, Present And A Future (Harlequin Superromance, 1178)",2004,4,0,3,2003,1
janice elliott,Figures in the Sand,1995,2,0,1,1987,8
janice elliott,Figures in the Sand,1995,3,0,1,1995,0
janice lee smith,The Kid Next Door and Other Headaches: Stories About Adam Joshua,1986,2,0,1,1981,5
janice lee smith,The show-and-tell war and other stories about Adam Joshua,1988,3,0,1,1986,2
janice woods windle,True Women,1995,2,0,8,1994,1
janice woods windle,Hill Country: A Novel,1998,3,0,2,1995,3
janice woods windle,Hill Country : A Novel,2000,4,3.3333333333333335,3,1998,2
janina renee,Tarot Spells (Llewellyn's New Age Tarot Series),2000,2,5,7,1994,6
janina renee,Tarot: Your Everyday Guide,2000,3,7,3,2000,0
janina renee,Tarot for a New Generation,2001,4,0,1,2000,1
janni lee simner,"The Haunted Trail (Phantom Rider , No 2)",1996,2,0,2,1996,0
japan travel bureau,"Eating in Japan (Jtb's Illustrated Book Series, Vol 3)",1987,2,10,1,1987,0
japan travel bureau,"Salaryman in Japan (Japan in Your Pocket Series, Vol 8)",1987,3,0,1,1987,0
japan travel bureau,"Who's Who in Japan (Japan Travel Bureau, No 9)",1987,4,0,1,1987,0
jaroslav hasek,The Red Commissar: Including Further Adventures of the Good Soldier Svejk and Other Stories,1983,2,0,2,1963,20
jaroslav hasek,The Good Soldier Svejk and His Fortunes in the World War (Penguin Twentieth-Century Classics),1985,3,8,2,1983,2
jaroslav hasek,The Good Soldier Svejk and His Fortunes in the World War (Penguin Modern Classics),2000,4,2.6666666666666665,3,1985,15
jason epstein,"Book Business: Publishing Past, Present, and Future",2002,2,0,1,2001,1
javier cercas,"Soldados De Salamina (Coleccion Andanzas, 433)",2001,2,3.8181818181818183,22,2001,0
javier cercas,Les Soldats de Salamine,2002,3,1.2941176470588236,17,2001,1
javier cercas,El Movil (Andanzas),2003,4,2.5,2,2002,1
javier cercas,Soldados De Salamina (Andanzas),2003,5,0,1,2003,0
javier cercas,El Vientre De LA Ballena,2003,6,0,1,2003,0
javier cercas,Soldiers of Salamis,2004,7,3.5,2,2003,1
javier martinez reverte,La Noche Detenida,2002,2,5.6,5,2001,1
jay conrad levinson,Guerrilla Marketing Attack (Guerrilla Marketing),1989,2,8,4,1979,10
jay conrad levinson,The Ninety-Minute Hour: Using Time Extension to Get the Most Out of Every Hour,1992,3,7,2,1989,3
jay conrad levinson,Guerrilla Marketing Excellence: The 50 Golden Rules for Small-Business Success (Guerrilla Marketing),1993,4,0,1,1992,1
jay conrad levinson,The Guerrilla Marketing Handbook (Guerrilla Marketing),1994,5,5,3,1993,1
jay conrad levinson,Guerrilla Marketing for the Home-Based Business,1995,6,4,2,1994,1
jay conrad levinson,Guerrilla Marketing Online: The Entrepreneur's Guide to Earning Profits on the Internet (Guerrilla Marketing),1997,7,1.6666666666666667,3,1995,2
jay leno,More Headlines,1990,2,4.25,4,1989,1
jay leno,"Headlines III : Not the Movie, Still the Book",1991,3,2.8333333333333335,6,1990,1
jay leno,Headlines IV : The Next Generation,1992,4,9,1,1991,1
jay leno,"Jay Leno's Headlines: Book I, II, III : Real but Ridiculous Headlines from America's Newspapers",1992,5,5.25,8,1992,0
jay leno,Jay Leno'S Police Blotter,1994,6,4,4,1992,2
jay leno,Jay Leno: Leading With My Chin,1996,7,2.5,6,1994,2
jay leno,Leading with My Chin,1997,8,0,3,1996,1
jayne bauling,Valentine'S Day (Harlequin Presents),1984,2,6,1,1982,2
jayne bauling,"Rage To Possess (Harlequin Presents, No 775)",1985,3,0,1,1984,1
jayne bauling,To Fill A Silence (Harlequin Presents),1986,4,0,2,1985,1
jayne bauling,Thai Triangle (Harlequin Presents),1986,5,0,1,1986,0
jayne bauling,Abode Of Princes (Harlequin Presents),1986,6,0,3,1986,0
jayne fisher,"Percival Pea, And, Polly Pomegranate",1979,2,3.5,2,1979,0
jean auel,Chasseurs De Mammouths 3,2002,2,3,2,1982,20
jean auel,Das Tal Der Pferde,2002,3,7.166666666666667,6,2002,0
jean auel,LA Vallee Des Cheveaux: Valley of the Horses,2002,4,0,3,2002,0
jean auel,Les Refuges De Pierre,2002,5,3.5,2,2002,0
jean auel,LA Clan De L'Ours Des Cavernes,2002,6,4,4,2002,0
jean auel,LA Clan De L'Ours Des Cavernes,2002,7,5,8,2002,0
jean auel,Ayla Und Der Stein Des Feuers,2002,8,8.5,2,2002,0
jean auel,Ayla Und Das Tal Der Peerde,2002,9,5.666666666666667,3,2002,0
jean auel,Mammut Jages,2002,10,0,2,2002,0
jean auel,Ayla Und Der Clan Des Baren,2002,11,6.25,4,2002,0
jean auel,Ayla Und Das Tal Der Grossen Mutter,2002,12,3.3636363636363638,11,2002,0
jean auel,Ayla Und der Clan Des Baren,2002,13,4.25,4,2002,0
jean auel,Focolari Di Pietra,2002,14,5,1,2002,0
jean auel,LA Pianure Del Passagio,2003,15,3,2,2002,1
jean barrett,"Ring Of Gold (Harlequin Desire, No 689)",1991,2,0,3,1990,1
jean barrett,"White Wedding (Harlequin Intrigue, No 351)",1995,3,0,3,1991,4
jean barrett,"Man Of The Midnight Sun (Mail Order Brides) (Harlequin Intrigue, No 384)",1996,4,0,4,1995,1
jean barrett,Delaney's Crossing,1997,5,0,3,1996,1
jean barrett,"Fugitive Father (Intrigue , No 475)",1998,6,0,1,1997,1
jean barrett,Archer's Crossing,1999,7,5,1,1998,1
jean barrett,McAllister's Crossing,2001,8,4,2,1999,2
jean barrett,The Hunt for Hawke's Daughter (Harlequin Intrigue 605),2001,9,2.7058823529411766,17,2001,0
jean barrett,Official Escort,2002,10,0.7142857142857143,7,2001,1
jean barrett,"Private Investigations (Harlequin Intrigue, No. 652)",2002,11,0,2,2002,0
jean barrett,"Cowboy Pi (Harlequin Intrigue, 728)",2003,12,1.875,8,2002,1
jean barrett,Sudden Recall (Harlequin Intrigue Series),2004,13,0.6666666666666666,3,2003,1
jean brashear,A Family Secret (Silhouette Special Edition),1999,2,0,2,1998,1
jean brashear,"Lonesome No More (Silhouette Special Edition, 1302)",2000,3,0,3,1999,1
jean brashear,"Texas Royalty (Special Edition, 1343)",2000,4,1.4285714285714286,7,2000,0
jean brashear,"Millionaire In Disguise (Special Edition, 1416)",2001,5,4,1,2000,1
jean brashear,"What The Heart Wants  (9 Months Later) (Harlequin Superromance, No. 1071)",2002,6,2.8,5,2001,1
jean brashear,The Good Daughter  (Deep In The Heart),2003,7,4.125,8,2002,1
jean brashear,The Healer  (Deep in the Heart),2003,8,3.625,8,2003,0
jean brashear,Sweet Child of Mine,2004,9,0,2,2003,1
jean brashear,Most Wanted : Deep In The Heart (Superromance),2004,10,10,1,2004,0
jean brashear,"A Real Hero (Harlequin Superromance, 1190)",2004,11,3.2,5,2004,0
jean campbell,Beadwork Creates Bracelets,2002,2,0,2,2001,1
jean campbell,Beadwork Creates Necklaces,2002,3,0,2,2002,0
jean campbell,Beadwork Creates Beaded Beads: 30 Designs (Beadwork Creates Series),2003,4,10,1,2002,1
jean campbell,Beadwork Creates Beaded Bags: 30 Designs (Beadwork Creates Series),2003,5,10,1,2003,0
jean davies okimoto,Molly by Any Other Name,1993,2,0,7,1982,11
jean davies okimoto,To Jaykae: Life Stinx,2000,3,2.3333333333333335,3,1993,7
jean giono,Les Ames fortes,1972,2,0,1,1972,0
jean giono,Un roi sans divertissement,1972,3,0,2,1972,0
jean giono,Solitude de la pitiÃ?Â©,1973,4,0,1,1972,1
jean giono,Ennemonde et autres caractÃ?Â¨res,1973,5,8,1,1973,0
jean giono,Jean le Bleu (Le Livre de poche ; 3649),1976,6,0,3,1973,3
jean giono,The Man Who Planted Trees,1985,7,10,1,1976,9
jean giono,The Man Who Planted Trees,1987,8,6.625,8,1985,2
jean giono,Regain,1987,9,3.111111111111111,9,1987,0
jean giono,La chasse au bonheur,1988,10,8,1,1987,1
jean giono,Colline,1992,11,7.5,2,1988,4
jean giono,Le Hussard sur le toit,1995,12,0.625,8,1992,3
jean giono,The Man Who Planted Trees,1999,13,10,1,1995,4
jean giono,Joy of Man's Desiring,1999,14,9,1,1999,0
jean giono,The Man Who Planted Trees,2000,15,2.5,4,1999,1
jean giono,Song of the World,2000,16,6,2,2000,0
jean giono,Le chant du monde,2000,17,0,2,2000,0
jean giono,L'Homme Qui Plantait Des Arbres,2002,18,6.666666666666667,3,2000,2
jean horton berg,Tuggy the Tugboat,1987,2,0,2,1984,3
jean lush,Women and Stress: A Practical Approach to Managing Tension,1992,2,4,2,1990,2
jean lush,Women and Stress: A Practical Approach to Managing Tension,1997,3,0,1,1992,5
jean lush,Mothers &amp; Sons: Raising Boys to Be Men,2001,4,7,1,1997,4
jean m. auel,The Clan of the Cave Bear : a novel,1981,2,4.589743589743589,39,1980,1
jean m. auel,The Valley of Horses (Earth's Children),1982,3,3.0833333333333335,12,1981,1
jean m. auel,"Valley of the Horses (Auel, Jean M. , Earth's Children.)",1983,4,3.135593220338983,59,1982,1
jean m. auel,Clan of the Cave Bear,1983,5,1.375,16,1983,0
jean m. auel,Valley of Horses,1983,6,1.875,8,1983,0
jean m. auel,The Valley of Horses,1984,7,4.361538461538461,130,1983,1
jean m. auel,The Clan of the Cave Bear (Earth's Children (Paperback)),1984,8,3.384259259259259,216,1984,0
jean m. auel,The Mammoth Hunters (Earth's Children (Paperback)),1986,9,3.3974358974358974,78,1984,2
jean m. auel,The Valley Of Horses   Part 1 Of 2,1986,10,0,1,1986,0
jean m. auel,The Clan Of The Cave Bear   Part 1 Of 2,1986,11,8.5,2,1986,0
jean m. auel,"The Mammoth Hunters (Auel, Jean M. , Earth's Children.)",1986,12,2.155844155844156,77,1986,0
jean m. auel,The Mammoth Hunters   Part 1 Of 2,1986,13,0,1,1986,0
jean m. auel,Plains of Passage (Earth's Children),1990,14,3.404255319148936,47,1986,4
jean m. auel,Mammoth Hunters (Earth's Children),1990,15,3.4166666666666665,48,1990,0
jean m. auel,The Plains of Passage (Earth's Children (Paperback)),1991,16,2.5467625899280577,139,1990,1
jean m. auel,The Plains of Passage,1991,17,3,1,1991,0
jean m. auel,The Plains Of Passage   Part 1 Of 2,1991,18,0,2,1991,0
jean m. auel,Valley of Horses (Thorndike Large Print Basic Series),1991,19,10,1,1991,0
jean m. auel,"The Clan of the Cave Bear (Earth's Children Series , No 1)",1998,20,2.8,10,1991,7
jean m. auel,The Valley of Horses,1999,21,4.5,2,1998,1
jean m. auel,The Plains of Passage (Earth's Children (Hardcover)),2001,22,3.75,4,1999,2
jean m. auel,"The Valley of Horses: A Novel (Auel, Jean M. Earth's Children.)",2001,23,4,8,2001,0
jean m. auel,"Clan del Oso Cavernario, El - Los Hijos de La Tierra",2001,24,1.6,5,2001,0
jean m. auel,The Clan of the Cave Bear,2001,25,9,1,2001,0
jean m. auel,"Cazadores de Mamuts, Los - Los Hijos de La Tierra 10b: Edicion",2001,26,4,1,2001,0
jean m. auel,The Clan of the Cave Bear,2001,27,6.833333333333333,12,2001,0
jean m. auel,El Valle de Los Caballos (Hijos de la Tierra),2001,28,3.5,2,2001,0
jean m. auel,The Mammoth Hunters,2001,29,3.625,16,2001,0
jean m. auel,"The Shelters of Stone (Earth's Children Series, No 5)",2002,30,3.827272727272727,110,2001,1
jean m. auel,"El clan del oso cavernario (Auel, Jean M. , Hijos De La Tierra.)",2002,31,4,4,2002,0
jean m. auel,The Clan of the Cave Bear,2002,32,3.75,4,2002,0
jean m. auel,Las llanuras del transito,2002,33,7,2,2002,0
jean m. auel,Los cazadores de mamuts,2002,34,7.5,2,2002,0
jean m. auel,"Les enfants de la terre, tome 4, volume 2 : Le retour d'Ayla",2002,35,0,1,2002,0
jean m. auel,"The Shelters of Stone: On 40 Cassettes (Earth's Children, 5)",2002,36,0,1,2002,0
jean m. auel,"El valle de los caballos (Auel, Jean M. Earth's Children.)",2002,37,7,2,2002,0
jean m. auel,Los refugios de piedra,2002,38,8,2,2002,0
jean m. auel,The Valley of Horses (Random House Large Print),2002,39,9,1,2002,0
jean m. auel,"The Shelters of Stone (Earth's Children, Book 5)",2003,40,2.473684210526316,76,2002,1
jean m. auel,"Les Enfants de la terre, tome 5 : Les Refuges de pierres, volume 1",2003,41,0,1,2003,0
jean m. auel,Ayla und der Stein des Feuers. Roman.,2003,42,0,3,2003,0
jean m. auel,The Shelters of Stone (Earth's Children (Paperback)),2004,43,5,2,2003,1
jean m. favors,My Soul to Keep (An Avon Flare Book),1994,2,0,1,1985,9
jean nash,Sand Castles,1988,2,0,1,1983,5
jean p. sasson,"Ich, Prinzessin aus dem Hause Al Saud. Ein Leben hinter tausend Schleiern.",1994,2,2.1666666666666665,6,1991,3
jean p. sasson,"Ich, Prinzessin Sultana, und meine TÃ?Â¶chter. Ein Leben hinter tausend Schleiern.",1996,3,1.1666666666666667,6,1994,2
jean p. sasson,Princess: A True Story of Life Behind the Veil in Saudi Arabia,1997,4,2.6666666666666665,42,1996,1
jean p. sasson,"Ich, Prinzessin Sultana. Freiheit fÃ?Â¼r mich und meine Schwestern.",1999,5,0,1,1997,2
jean p. sasson,Princess Sultana's Circle,2000,6,3.5714285714285716,7,1999,1
jean p. sasson,"Ich, Prinzessin aus dem Hause Al Saud / Ich, Prinzessin Sultana, und meine TÃ?Â¶chter.",2001,7,0,1,2000,1
jean p. sasson,Princess Sultana's Daughters,2001,8,4.714285714285714,7,2001,0
jean p. sasson,Ester's Child,2001,9,5,3,2001,0
jean p. sasson,"Mayada, Daughter of Iraq: One Woman's Survival Under Saddam Hussein",2003,10,4,5,2001,2
jean rouaud,Of Illustrious Men,1994,2,0,1,1990,4
jean rouaud,The World More or Less,1998,3,0,1,1994,4
jean rouaud,El Mundo Mas O Menos,1999,4,7,1,1998,1
jean rouaud,Die Felder der Ehre.,2000,5,1.5,2,1999,1
jean swanson,Poor-Bashing: The Politics of Exclusion,2002,2,0,1,1998,4
jean swanson,The Dick Francis Companion,2003,3,2.6666666666666665,3,2002,1
jean toomer,Cane (Norton Critical Edition),1988,2,2.75,4,1975,13
jean toomer,Cane,1993,3,6,3,1988,5
jean wickstrom liles,All-Time Favorite Soup &amp; Stew Recipes,1996,2,0,1,1995,1
jean wyrick,Steps to Writing Well With Additional Readings,1997,2,0,1,1986,11
jean-dominique bauby,Le scaphandre et le papillon,1997,2,5,3,1997,0
jean-dominique bauby,The Diving Bell and the Butterfly : A Memoir of Life in Death,1997,3,3.6666666666666665,18,1997,0
jean-dominique bauby,The Diving Bell and the Butterfly : A Memoir of Life in Death,1998,4,4.891891891891892,37,1997,1
jean-dominique bauby,Schmetterling und Taucherglocke.,1998,5,8.5,2,1998,0
jean-dominique bauby,Le Scaphandre Et Le Papillon,1999,6,4.625,8,1998,1
jean-franã?â§ois deniau,Tadjoura,2001,2,0,1,1992,9
jean-jacques sempe,Les Recres Du Petit Nicolas,1997,2,5,2,1988,9
jean-jacques sempe,Le monde du petit Nicolas. (Lernmaterialien),1998,3,4,2,1997,1
jean-jacques sempe,La vie est comme ca. Scenes de la vie mouvementee du Petit Nicholas. (Lernmaterialien),2001,4,4,2,1998,3
jean-jacques sempe,L' univers du petit Nicolas. (Lernmaterialien),2002,5,0,2,2001,1
jean-pierre verdet,Universe (First Discovery Books),1997,2,0,2,1992,5
jeanne allen,Twilight Crossings,2003,2,5,1,1992,11
jeanne avery,Astrological Aspects: Your Inner Dialogues,1985,2,5,2,1982,3
jeanne avery,Astrology and Your Past Lives,1987,3,10,2,1985,2
jeanne avery,A Soul's Journey: Empowering the Present Through Past Life Regression,1996,4,0,2,1987,9
jeanne avery,"Past Lives, Present Loves",1999,5,3.3333333333333335,3,1996,3
jeanne kalogridis,Children of the Vampire: The Diaries of the Family Dracul,1995,2,1.0909090909090908,11,1994,1
jeanne kalogridis,Covenant with the Vampire (Diaries of the Family Dracul),1995,3,2.9,30,1995,0
jeanne kalogridis,Children of the Vampire: The Diaries of the Family Dracul (Diaries of the Family Dracul),1996,4,3,21,1995,1
jeanne kalogridis,Lord of the Vampires : The Diaries of the Family Dracul,1996,5,2.125,8,1996,0
jeanne kalogridis,Lord of the Vampires: The Diaries of the Family Dracul (Diaries of the Family Darcul),1997,6,7,1,1996,1
jeanne kalogridis,Lord of the Vampires: The Diaries of the Family Dracul (Diaries of the Family Darcul),1997,7,2.3,20,1997,0
jeanne kalogridis,The Burning Times : A Novel of Medieval France,2001,8,1.875,16,1997,4
jeanne kalogridis,The Burning Times: A Novel,2002,9,2.3529411764705883,17,2001,1
jeanne m. dams,The Body in the Transept (Dorothy Martin Mysteries (Paperback)),1996,2,0.75,8,1996,0
jeanne m. dams,Holy Terror in the Hebrides: A Dorothy Martin Mystery (Walker Mystery),1997,3,0,1,1996,1
jeanne m. dams,Trouble in the Town Hall (Dorothy Martin Mysteries (Paperback)),1998,4,0,3,1997,1
jeanne m. dams,Malice in Miniature: A Dorothy Martin Mystery (Dorothy Martin Mysteries (Hardcover)),1998,5,2.3333333333333335,3,1998,0
jeanne m. dams,Death in Lacquer Red: A Hilda Johansson Mystery (Walker Mysteries),1999,6,2.142857142857143,7,1998,1
jeanne m. dams,Holy Terror in the Hebrides : A Dorothy Martin Mystery (Dorothy Martin Mysteries (Paperback)),1999,7,2.3333333333333335,9,1999,0
jeanne m. dams,Killing Cassidy: A Dorothy Martin Mystery (Dorothy Martin Mysteries (Hardcover)),2000,8,0,1,1999,1
jeanne m. dams,Malice in Miniature (Dorothy Martin Mysteries (Paperback)),2000,9,1.4,5,2000,0
jeanne m. dams,"Red, White, and Blue Murder : A Hilda Johansson Mystery",2000,10,0,2,2000,0
jeanne m. dams,To Perish in Penzance (Dorothy Martin Mysteries (Hardcover)),2001,11,0,3,2000,1
jeanne m. dams,Silence Is Golden: A Hilda Johansson Mystery (Hilda Johansson Mysteries (Hardcover)),2002,12,4.5,2,2001,1
jeanne m. dams,Sins Out of School: A Dorothy Martin Mystery,2003,13,4.6,5,2002,1
jeanne m. dams,"Sins Out Of School (Wwl Mystery, 474)",2003,14,0,1,2003,0
jeanne mcsweeney,"Getting to Know You: 365 Questions, Activities, Observations and Ways to Get to Know Another Person Better",1994,2,0,1,1992,2
jeanne montague,Wild Bride (Heartfire Romance),1994,2,3.3333333333333335,3,1988,6
jeanne oliver,"Frommer's 2000 Paris from $80 a Day: The Ultimate Guide to Comfortable Low-Cost Travel (Frommer's Paris from $... a Day, 2000)",1999,2,9,1,1997,2
jeanne oliver,Lonely Planet Croatia (1st ed),1999,3,0,1,1999,0
jeanne oliver,Lonely Planet Croatia (Lonely Planet Croatia),2002,4,0,1,1999,3
jeanne oliver,Lonely Planet France (Lonely Planet France),2003,5,10,1,2002,1
jeanne ray,Julie and Romeo (Thorndike Large Print Basic Series),2000,2,0,1,2000,0
jeanne ray,Julie and Romeo,2000,3,4.416666666666667,24,2000,0
jeanne ray,Julie and Romeo: A Novel,2001,4,3.480769230769231,52,2000,1
jeanne ray,Step-Ball-Change,2002,5,3.0434782608695654,23,2001,1
jeanne ray,Step-Ball-Change,2003,6,3.8181818181818183,22,2002,1
jeanne ray,Julie and Romeo,2003,7,2,4,2003,0
jeanne ray,Eat Cake : A Novel,2003,8,2.1153846153846154,26,2003,0
jeanne ray,Eat Cake,2004,9,6,1,2003,1
jeanne ray,Step-Ball-Change,2004,10,0,1,2004,0
jeanne wakatsuki houston,The Legend of Fire Horse Woman,2003,2,0,1,1986,17
jed diamond,Surviving Male Menopause.  A Guide for Women and Men,2000,2,0,1,1989,11
jeff albrecht,Watch Me Grow (Growth Chart Coloring),2001,2,0,1,2000,1
jeff albrecht,Cassie's Magical Crayon (Dragon Tales (Random House Paperback)),2002,3,10,1,2001,1
jeff ball,Self-Sufficient Suburban Gardener,1986,2,0,1,1983,3
jeff ball,Rodale's Landscape Problem Solver: A Plant-By-Plant Guide,1989,3,0,1,1986,3
jeff ball,Yardening,1992,4,0,1,1989,3
jeff doyle,"Routing TCP/IP, Volume II (CCIE Professional Development)",2001,2,0,1,1998,3
jeff koon,Wearing of This Garment Does Not Enable You to Fly : 101 Real Dumb Warning Labels,2003,2,0,1,2002,1
jeff perk,Moon Handbooks: Boston 2 Ed,2001,2,8,1,1998,3
jeff perk,"Moon Handbooks: Massachusetts, including Boston, the Berkshires, and Cape Cod (2nd edition)",2002,3,0,1,2001,1
jeff perk,"Car-Free in Boston: A Guide for Locals and Visitors, 10th Edition",2003,4,10,1,2002,1
jeffrey brown,Unlikely,2003,2,0,1,2003,0
jeffrey hollender,How to Make the World a Better Place: A Guide to Doing Good,1990,2,3.75,8,1989,1
jeffrey hollender,How to Make the World a Better Place: 116 Ways You Can Make a Difference,1995,3,0.7777777777777778,9,1990,5
jeffrey hollender,"What Matters Most: How a Small Group of Pioneers Is Teaching Social Responsibility to Big Business, and Why Big Business Is Listening",2003,4,0,1,1995,8
jeffrey layton,Warhead,1997,2,5,2,1995,2
jeffrey m. shaara,Rise to Rebellion : A Novel of the American Revolution,2001,2,0,1,1998,3
jeffrey m. shaara,Rise to Rebellion,2002,3,2.727272727272727,22,2001,1
jeffrey m. shaara,The Glorious Cause,2003,4,0,1,2002,1
jeffrey m. shaara,The Glorious Cause,2003,5,2,7,2003,0
jeffrey m. shaara,Gone for Soldiers : A Novel of the Mexican War,2003,6,0,5,2003,0
jeffrey p. davidson,The Complete Idiot's Guide to Managing Stress (2nd Edition),1999,2,4,2,1987,12
jeffrey p. davidson,Marketing for the Home-Based Business,1999,3,0,1,1999,0
jeffrey p. davidson,The Complete Idiot's Guide to Reinventing Yourself,2001,4,4.666666666666667,3,1999,2
jeffrey rubin,When Families Fight: How to Handle Conflict With Those You Love,1990,2,0,3,1989,1
jeffrey zeldman,Designing with Web Standards,2003,2,9,2,2001,2
jehan sadat,Ich bin eine Frau aus Ã?Â?gypten.,1991,2,1.3333333333333333,6,1989,2
jemiah jefferson,Wounds,2002,2,0.9,10,2001,1
jen hill,An Exhilaration of Wings: The Literature of Bird Watching,2001,2,0,1,1999,2
jen holling,"Forever, My Lady",2001,2,0,3,1999,2
jen holling,Captured by Your Kiss: Brides of the Bloodstone,2002,3,4.25,4,2001,1
jen holling,Tamed by Your Desire (Brides Of The Bloodstone),2002,4,3,5,2002,0
jen holling,Tempted by Your Touch (Brides Of The Bloodstone),2002,5,1.6,5,2002,0
jeneth murrey,Hell is My Heaven (Harlequin Romance),1982,2,0,3,1982,0
jeneth murrey,Forsaking All Othe (Harlequin Romance),1983,3,0,1,1982,1
jeneth murrey,Tame A Proud Heart (Harlequin Romance),1983,4,0,1,1983,0
jeneth murrey,Double Doubting,1984,5,2.3333333333333335,3,1983,1
jeneth murrey,"Had We Never Loved (Harlequin Presents, No 781)",1985,6,0,1,1984,1
jeneth murrey,Return To Arkady,1985,7,0,1,1985,0
jeneth murrey,"Waiting Man (Harlequin Romance, No 2807)",1986,8,0,3,1985,1
jeneth murrey,"Bittersweet Marriage (Harlequin Presents, No 990)",1987,9,0,1,1986,1
jeneth murrey,"Impulsive Proposal (Harlequin Romance, 3039)",1990,10,0,1,1987,3
jennie louise frankel,You'll Never Make Love in This Town Again,1996,2,2,4,1996,0
jennie louise frankel,You'll Never Make Love in This Town Again,1996,3,7,1,1996,0
jennifer archer,Once upon a Dream,2001,2,1.75,4,1999,2
jennifer archer,Shocking Behavior,2002,3,1.9166666666666667,12,2001,1
jennifer archer,Heat Wave,2003,4,1.6666666666666667,3,2002,1
jennifer donnelly,A Northern Light,2003,2,2.1666666666666665,6,2003,0
jennifer donnelly,The Tea Rose,2004,3,2.933333333333333,15,2003,1
jennifer james,Women and the Blues: Passions That Hurt Passions That Heal,1988,2,3,2,1986,2
jennifer james,"Women and the Blues : Passions That Hurt, Passions That Heal",1990,3,0,1,1988,2
jennifer james,THINKING IN THE FUTURE TENSE,1997,4,7,1,1990,7
jennifer lauck,Blackbird : A Childhood Lost And  Found,2000,2,0,1,2000,0
jennifer lauck,Still Waters,2001,3,0,2,2000,1
jennifer lauck,Blackbird : A Childhood Lost and Found,2001,4,3.46875,32,2001,0
jennifer lauck,Still Waters,2001,5,3.7857142857142856,28,2001,0
jennifer lauck,Still Waters,2002,6,4.4,5,2001,1
jennifer peterson,Heaven Sent (Four Complete Romances in One Volume),2003,2,0,1,2000,3
jennifer sarasin,"Taking over (Cheerleaders, No 26)",1987,2,0,1,1984,3
jennifer weiner,Station Gehenna,1988,2,5,2,1983,5
jennifer weiner,Good in Bed,2001,3,4.4,20,1988,13
jennifer weiner,Good In Bed,2001,4,4,2,2001,0
jennifer weiner,In Her Shoes : A Novel,2002,5,7,1,2001,1
jennifer weiner,In Her Shoes : A Novel,2002,6,3.4909090909090907,55,2002,0
jennifer weiner,Good in Bed,2002,7,4.040425531914893,470,2002,0
jennifer weiner,In Her Shoes : A Novel,2002,8,8,2,2002,0
jennifer weiner,In Her Shoes : A Novel,2003,9,3.431654676258993,139,2002,1
jennifer weiner,Little Earthquakes : A Novel,2004,10,5,2,2003,1
jennifer wilde,Loves Tender Fury,1982,2,0,1,1981,1
jennifer wilde,Once More Miranda,1983,3,0.625,8,1982,1
jennifer wilde,Love's Tender Fury,1983,4,1,1,1983,0
jennifer wilde,Angel in Scarlet,1986,5,2.727272727272727,11,1983,3
jennifer wilde,The Slipper,1987,6,0,2,1986,1
jennifer wilde,They Call Her Dana,1989,7,2.6,10,1987,2
jennifer wilde,When Love Commands,1991,8,0,2,1989,2
jennifer wilde,The Slipper -Trade Pb,1993,9,2,1,1991,2
jenny arden,"Some Enchanted Evening (Harlequin Romance, No 2995)",1989,2,0,4,1988,1
jenny arden,"Intense Involvement (Harlequin Romance, No 3055)",1990,3,0,1,1989,1
jenny arden,"Arrogant Invader (Harlequin Romance, No 3115)",1991,4,5,1,1990,1
jenny arden,Running Scared (Harlequin Presents/#1399),1991,5,0,3,1991,0
jenny craig,Jenny Craig's Little Survival Guide: 201 Tips for Managing Your Weight and Your Life,1996,2,0,1,1995,1
jenny craig,Jenny Craig's No Diet Required: Recipes for Healthy Living,1997,3,0,1,1996,1
jenny loring,"Interlude (Superromance, No 388)",1989,2,0,1,1987,2
jenny lykins,Lost Yesterday (Time Passages Romance),1997,2,1,9,1997,0
jenny lykins,Echoes of Tomorrow (Time Passages Romance),1997,3,0,3,1997,0
jenny lykins,Distant Dreams (Time Passages),1998,4,2.3333333333333335,3,1997,1
jenny lykins,River of Dreams (Time Passages Romance Series),1999,5,1.4,5,1998,1
jenny oldfield,Third-Time Lucky (Horses of Half Moon Ranch Series),2001,2,0,1,2001,0
jenny oldfield,Summer Special: Jethro Jr (Half Moon Ranch Series),2001,3,0,1,2001,0
jenny oldfield,"You Must Be Joking, Jimmy (Definitely Daisy)",2003,4,0,1,2001,2
jenny oldfield,"Just You Wait, Winona (Definitely Daisy)",2003,5,0,1,2003,0
jenny oldfield,"You're a Disgrace, Daisy (Definitely Daisy)",2003,6,5,2,2003,0
jenny oldfield,After Hours,2003,7,2,2,2003,0
jenny oldfield,"I'd Like a Little Word, Leonie (Definitely Daisy)",2003,8,0.3333333333333333,3,2003,0
jenoyne adams,Resurrecting Mingus,2002,2,5.666666666666667,3,2001,1
jenoyne adams,Selah's Bed: A Novel,2003,3,1.5,4,2002,1
jens christian grondahl,Silence in October,2002,2,0,2,2001,1
jens sparschuh,Der Zimmerspringbrunnen. Ein Heimatroman.,1997,2,3.25,4,1993,4
jens sparschuh,Die schÃ?Â¶ne Belinda und ihr Erfinder. ( Ab 8 J.).,2001,3,0,1,1997,4
jeremy flint,Bridge: The First Principles,1985,2,0,1,1977,8
jeremy jackson,Life at These Speeds: A Novel,2003,2,0,1,2003,0
jerome a. barron,Constitutional Law in a Nutshell (3rd ed) (Nutshell Series),1995,2,0,1,1986,9
jerome e. kaufmann,"College Algebra (with CD-ROM, Make the Grade, and InfoTrac)",2001,2,0,1,1999,2
jerome lawrence,Inherit the Wind,1982,2,3.5789473684210527,19,1982,0
jerome lawrence,The Night Thoreau Spent in Jail,1983,3,1.6666666666666667,6,1982,1
jerome lawrence,Inherit the Wind.,1998,4,0,1,1983,15
jerome tuccille,Trump: The Saga of America's Most Powerful Real Estate Baron,1988,2,0,1,1984,4
jerry honeycutt,Windows 95 and Nt 4.0 Registry &amp; Customization Handbook,1997,2,0,1,1996,1
jerry honeycutt,Using the Internet (Using ... (Que)),1997,3,10,1,1997,0
jerry schad,California Deserts (Geographic Series),1988,2,0,1,1983,5
jerry schad,Afoot and Afield in Los Angeles County,1991,3,9,1,1988,3
jerry schad,Afoot &amp; Afield in San Diego (Afoot &amp; Afield),1998,4,0,1,1991,7
jerry spinelli,Space Station Seventh Grade,1985,2,5,1,1982,3
jerry spinelli,Jason and Marceline,1986,3,6,1,1985,1
jerry spinelli,WHO PUT THAT HAIR IN MY TOOTHBRUSH?,1986,4,3.3333333333333335,3,1986,0
jerry spinelli,Maniac Magee,1990,5,6.5,2,1986,4
jerry spinelli,"Report to the Principal's Office (Spinelli, Jerry. School Daze.)",1991,6,0,2,1990,1
jerry spinelli,Space Station Seventh Grade,1991,7,0,2,1991,0
jerry spinelli,Maniac Magee,1992,8,2.6315789473684212,19,1991,1
jerry spinelli,Report to the Principals Office (School Days Series),1992,9,1.2,5,1992,0
jerry spinelli,Who Ran My Underwear Up the Flagpole?,1992,10,0.8333333333333334,6,1992,0
jerry spinelli,There's a Girl in My Hammerlock,1993,11,0,2,1992,1
jerry spinelli,Picklemania (School Daze),1993,12,1,2,1993,0
jerry spinelli,Maniac Magee (Thorndike Large Print General Fiction),1993,13,10,1,1993,0
jerry spinelli,Who Put That Hair in My Toothbrush?,1994,14,0,2,1993,1
jerry spinelli,Do the Funky Pickle (School Daze),1995,15,6,2,1994,1
jerry spinelli,Fourth Grade Rats,1996,16,1.2,15,1995,1
jerry spinelli,Crash,1996,17,2.3333333333333335,3,1996,0
jerry spinelli,The Library Card,1997,18,0,1,1996,1
jerry spinelli,Crash,1997,19,1.1428571428571428,7,1997,0
jerry spinelli,The Library Card (Apple Signature Edition),1998,20,3.1666666666666665,18,1997,1
jerry spinelli,Wringer (Trophy Newbery),1998,21,3.5833333333333335,12,1998,0
jerry spinelli,Library Card,1998,22,5,1,1998,0
jerry spinelli,Wringer,1998,23,4.75,4,1998,0
jerry spinelli,Knots in My Yo-Yo String: The Autobiography of a Kid,1998,24,0,1,1998,0
jerry spinelli,Maniac Magee,1999,25,3.6153846153846154,13,1998,1
jerry spinelli,Who Put that Hair in My Toothbrush?,2000,26,6.333333333333333,3,1999,1
jerry spinelli,Crash,2000,27,0,2,2000,0
jerry spinelli,Stargirl,2000,28,9,1,2000,0
jerry spinelli,"East End, West End und dazwischen Maniac Magee.",2000,29,0,1,2000,0
jerry spinelli,Stargirl,2000,30,5.027777777777778,36,2000,0
jerry spinelli,Stargirl (Orchard Black Apple S.),2001,31,4.5,8,2000,1
jerry spinelli,Taubenjagd. ( Ab 12 J.).,2001,32,0,1,2001,0
jerry spinelli,Stargirl. ( Ab 12 J.).,2002,33,0,1,2001,1
jerry spinelli,Stargirl,2002,34,0,1,2002,0
jerry spinelli,Stargirl,2002,35,3.9594594594594597,74,2002,0
jerry spinelli,Maniac Magee,2002,36,2.6875,32,2002,0
jerry spinelli,Loser,2002,37,4.666666666666667,3,2002,0
jerry spinelli,Loser,2003,38,3,3,2002,1
jerry spinelli,Crash. Das Leben ist Football.,2003,39,0,2,2003,0
jerry spinelli,Wringer,2004,40,0,1,2003,1
jerry spinelli,"Tooter Pepperday (Stepping Stone,  paper)",2004,41,0,1,2004,0
jerry stahl,Perv: A Love Story,2001,2,3.6,5,1998,3
jerry stahl,Plainclothes Naked,2002,3,7,1,2001,1
jesse liberty,Teach Yourself C++ in 24 Hours (Teach Yourself in 24 Hours Series),1997,2,5.5,2,1994,3
jesse liberty,Teach Yourself C++ in 21 Days (Sams Teach Yourself ... in 21 Days),1997,3,4.5,2,1997,0
jesse liberty,Sam's Teach Yourself C++ in 21 Days (3rd Complete Compiler Edition),1999,4,3,1,1997,2
jesse liberty,WebClasses From Scratch,1999,5,2.5,2,1999,0
jesse liberty,Sam's Teach Yourself C++ in 24 Hours (2nd Edition),1999,6,0,2,1999,0
jesse liberty,"Sams Teach Yourself C++ in 21 Days, Third Edition",1999,7,0,1,1999,0
jesse liberty,Sams Teach Yourself C++ in 10 Minutes,1999,8,0,1,1999,0
jesse liberty,XML Web Documents From Scratch (From Scratch),2000,9,4,1,1999,1
jesse liberty,Sams Teach Yourself C++ in 10 Minutes (2nd Edition),2002,10,0,1,2000,2
jesse liberty,"Programming C#, Third Edition",2003,11,0,1,2002,1
jessica durlacher,De dochter: Roman,2000,2,0,1,1999,1
jessica durlacher,Die Tochter.,2001,3,8,1,2000,1
jessica durlacher,Das Gewissen.,2001,4,3,2,2001,0
jessie smith,Grover's Day at the Beach: A Counting Story (Sesame Street Get Ready Series),1988,2,0,1,1988,0
jesãºs moncada,La galeria de les estÃ tues,1992,2,6,1,1988,4
jhonen vasquez,Johnny The Homicidal Maniac : Director's Cut,1999,2,7.666666666666667,6,1998,1
jill briscoe,Prayer That Works,2000,2,0,1,1995,5
jill dupleix,"Bread, Tomato, Garlic: Quick Cooking With 3 Main Ingredients",1999,2,9,1,1996,3
jill eisenstadt,From Rockaway (Vintage Contemporaries (Paperback)),1988,2,6,3,1987,1
jill gascoine,UnersÃ?Â¤ttlich. Roman einer verhÃ?Â¤ngnisvollen Obsession.,1998,2,0,1,1995,3
jill henry,A Candle in the Window (Zebra Historical Romance),2000,2,0,6,1999,1
jill jarnow,"A Shot at Love (Sweet Dreams, No 80)",1985,2,0,1,1975,10
jill jones,My Lady Caroline,1996,2,2,5,1995,1
jill jones,The Scottish Rose,1997,3,1.8571428571428572,7,1996,1
jill jones,Essence of My Desire,1998,4,0,2,1997,1
jill jones,Circle of the Lily,1998,5,1.5,4,1998,0
jill jones,The Island,1999,6,0,8,1998,1
jill jones,Bloodline,2000,7,1.3333333333333333,6,1999,1
jill jones,Remember Your Lies,2001,8,0,5,2000,1
jill jones,Every Move You Make,2002,9,2.25,4,2001,1
jill mansell,Solo,1992,2,0,2,1991,1
jill mansell,Kiss,1993,3,0,1,1992,1
jill mansell,Sheer Mischief,1994,4,0,1,1993,1
jill mansell,Open House,1995,5,0,2,1994,1
jill mansell,Two's Company,1996,6,7,1,1995,1
jill mansell,Miranda's Big Mistake,1999,7,0,1,1996,3
jill mansell,Perfect Timing,1999,8,1.72,25,1999,0
jill mansell,Good at Games,2000,9,0,8,1999,1
jill mansell,Nadia Knows Best,2004,10,5.333333333333333,9,2000,4
jill mansell,Two's Company,2004,11,0,1,2004,0
jill mccorkle,Ferris Beach: A Novel,1990,2,3,3,1985,5
jill mccorkle,July 7th (Front Porch Paperbacks),1992,3,3.6666666666666665,9,1990,2
jill mccorkle,Crash Diet,1992,4,0,3,1992,0
jill mccorkle,The Cheer Leader,1992,5,2.3333333333333335,3,1992,0
jill mccorkle,Ferris Beach,1993,6,8,1,1992,1
jill mccorkle,Crash Diet: Stories,1993,7,3.75,4,1993,0
jill mccorkle,Carolina Moon: A Novel,1996,8,3.25,8,1993,3
jill mccorkle,Carolina Moon: A Novel (Ballantine Reader's Circle),1997,9,2.6666666666666665,12,1996,1
jill mccorkle,Crash Diet: Stories,1997,10,0,1,1997,0
jill mccorkle,Tending to Virginia: A Novel,1997,11,2,4,1997,0
jill mccorkle,Final Vinyl Days and Other Stories,1998,12,0,1,1997,1
jill mccorkle,Final Vinyl Days: And Other Stories (Ballatine Reader's Circle),1999,13,7,1,1998,1
jill smolinski,Flip-Flopped: A Novel,2003,2,0.7,10,2002,1
jilly cooper,Octavia,1977,2,4,2,1976,1
jilly cooper,Class: A view from middle England,1979,3,9,1,1977,2
jilly cooper,Emily,1981,4,0,1,1979,2
jilly cooper,Lisa &amp; Co,1981,5,0,2,1981,0
jilly cooper,Jolly Marsupial: Down Under and Other Scenes,1982,6,0,2,1981,1
jilly cooper,Riders,1986,7,0,3,1982,4
jilly cooper,Rivals Hardcover,1989,8,8,1,1986,3
jilly cooper,Angels Rush in,1991,9,3,2,1989,2
jilly cooper,How to Survive Christmas,1992,10,0,1,1991,1
jilly cooper,Emily,1998,11,0,1,1992,6
jilly cooper,Score!,1999,12,3.5,4,1998,1
jilly cooper,Pandora,2002,13,0,1,1999,3
jim alexander,"When Somebody Needs You (Silhouette Special Edition, No 784)",1992,2,3.75,4,1989,3
jim alexander,When Somebody Loves You (Silhouette Special Edition 9748),1992,3,0,1,1992,0
jim alexander,Here Comes The Groom,1993,4,0,1,1992,1
jim alexander,"Smart Bomb  (Nomad #3) (Nomad, No 3)",1993,5,0,1,1993,0
jim alexander,"Mother Of The Groom (Silhouette Special Edition, No 9801)",1993,6,0,1,1993,0
jim alexander,"Say You Love Me (Silhouette Special Edition, No 875)",1994,7,2.5,2,1993,1
jim alexander,"Real Elizabeth Hollister.. (Silhouette Special Edition, No 940)",1995,8,0,2,1994,1
jim alexander,"Fancy Free (Harlequin Temptation, No 536)",1995,9,0,2,1995,0
jim alexander,"This Child Is Mine (Silhouette Special Edition, No 989)",1995,10,0,1,1995,0
jim alexander,"Bride For John (Three Brides And A Baby) (Silhouette Special Education, No 1047)",1996,11,5.666666666666667,3,1995,1
jim alexander,"Baby For Rebecca (Three Brides And A Baby) (Harlequin Special Edition, No 1070)",1996,12,3.5,2,1996,0
jim alexander,"Bride For Luke (Three Brides And A Baby) (Silhouette Special Edition, No 1024)",1996,13,5,2,1996,0
jim alexander,"All Shook Up (Harlequin Temptation, No 598)",1996,14,0,1,1996,0
jim alexander,"Madcap Heiress (Harlequin Love &amp; Laughter, No 8)",1996,15,0,2,1996,0
jim alexander,"Stop The Wedding (Silhouette Special Edition, No 1097)",1997,16,0,1,1996,1
jim alexander,"With This Wedding Ring (Harlequin Special Edition, No 1169)",1998,17,5,2,1997,1
jim alexander,"A Touch of Black Velvet (Harlequin Temptation, No 704)",1998,18,0,3,1998,0
jim alexander,"Mother For Jeffrey (Silhouette Special Edition, 1211)",1998,19,0,1,1998,0
jim alexander,"Black Velvet (Harlequin Temptation, No 689)",1998,20,2.3333333333333335,3,1998,0
jim alexander,"Black Velvet Valentines (Harlequin Temptation, No 720)",1999,21,0,2,1998,1
jim alexander,"Wedding Bells And Mistletoe (Callahans &amp; Kin) (Silhouette Special Edition, 1289)",1999,22,2.6666666666666665,3,1999,0
jim alexander,Merry Gentleman,1999,23,0,2,1999,0
jim alexander,Love Child,1999,24,0,1,1999,0
jim alexander,Forever Husband (Love Inspired (Numbered)),1999,25,0,1,1999,0
jim alexander,"Falling For An Older Man (Callaghans &amp; Kin) (Special Edition, 1308)",2000,26,7,3,1999,1
jim burke,"Reading Reminders : Tools, Tips, and Techniques",2000,2,10,1,1999,1
jim craddock,VideoHound's Golden Movie Retriever 2002,2001,2,3.3333333333333335,3,2000,1
jim davis,Garfield gains weight,1981,2,1.6666666666666667,6,1980,1
jim davis,"Garfield, bigger than life",1981,3,1.6,5,1981,0
jim davis,Garfield Weighs in (Garfield classics),1982,4,0,8,1981,1
jim davis,The Garfield Treasury,1982,5,5.428571428571429,7,1982,0
jim davis,Here Comes Garfield,1982,6,0,1,1982,0
jim davis,Here Comes Garfield,1982,7,5,2,1982,0
jim davis,Garfield the Pirate,1982,8,0,1,1982,0
jim davis,Garfield Treasury,1982,9,0,1,1982,0
jim davis,Garfield Pocket Books: Why Do You Hate Mondays? (Garfield Pocket Books),1982,10,0,2,1982,0
jim davis,Garfield takes the cake,1982,11,2.6,5,1982,0
jim davis,Garfield Pocket Books: The Great Lover (Garfield Pocket Books),1982,12,7.5,2,1982,0
jim davis,Garfield: The Knight in Shining Armor,1982,13,3.5,2,1982,0
jim davis,Garfield Sits Around the House,1983,14,2.8333333333333335,6,1982,1
jim davis,Garfield Goes Underground,1983,15,0,1,1983,0
jim davis,Garfield Eats His Heart Out,1983,16,2.142857142857143,7,1983,0
jim davis,Garfield in Space,1983,17,1.5,4,1983,0
jim davis,The second Garfield treasury,1983,18,3.5,2,1983,0
jim davis,Garfield on the Town,1983,19,1.3333333333333333,3,1983,0
jim davis,"Garfield Pocket Books: Admit It, Odie's OK! (Garfield Pocket Books)",1983,20,5,1,1983,0
jim davis,Garfield Eats His Heart Out (Garfield (Numbered Paperback)),1984,21,3.857142857142857,7,1983,1
jim davis,Garfield Pocket Books: Who's Talking? (Garfield Pocket Books),1984,22,4.666666666666667,3,1984,0
jim davis,Garfield at Large (Garfield (Numbered Paperback)),1984,23,0,4,1984,0
jim davis,"Garfield, His 9 Lives",1984,24,0,1,1984,0
jim davis,Garfield Sits Around the House (Garfield (Numbered Paperback)),1984,25,4.384615384615385,13,1984,0
jim davis,Garfield in the Rough,1984,26,2.5,4,1984,0
jim davis,Garfield Tips the Scales 8 (Garfield (Numbered Paperback)),1984,27,1.4,10,1984,0
jim davis,Garfield Loses His Feet (Garfield (Numbered Paperback)),1984,28,1.7272727272727273,11,1984,0
jim davis,Garfield Pocket Books: Strikes Again (Garfield Pocket Books),1984,29,9,1,1984,0
jim davis,Garfield Takes the Cake (Garfield (Numbered Paperback)),1984,30,4.333333333333333,6,1984,0
jim davis,Garfield Pocket Books: What's Cooking? (Garfield Pocket Books),1984,31,5,4,1984,0
jim davis,Garfield: His 9 Lives,1984,32,1.3333333333333333,3,1984,0
jim davis,Garfield's Halloween Adventure (Formerly Titled Garfield in Disguise),1985,33,2,10,1984,1
jim davis,Garfield Pocket Books: We Love You Too (Garfield Pocket Books),1985,34,9,1,1985,0
jim davis,Garfield Makes It Big (Garfield (Numbered Paperback)),1985,35,2.0833333333333335,12,1985,0
jim davis,Garfield Pocket Books: Here's Looking at You (Garfield Pocket Books),1985,36,9,1,1985,0
jim davis,Third Garfield Treasury,1985,37,0,2,1985,0
jim davis,Garfield in Paradise,1986,38,3.4285714285714284,7,1985,1
jim davis,Garfield Pocket Books: Here We Go Again (Garfield Pocket Books),1986,39,9,1,1986,0
jim davis,Garfield Out to Lunch (Garfield (Numbered Paperback)),1986,40,0,4,1986,0
jim davis,Garfield Trivia Book: By Jim Davis With Bill Tornquist,1986,41,0,3,1986,0
jim davis,Garfield Pocket Books: Life and Lasagne (Garfield Pocket Books),1986,42,2.5,2,1986,0
jim davis,"The Unabridged, Uncensored, Unbelievable Garfield",1986,43,4.6,5,1986,0
jim davis,Garfield Pocket Books: Just Good Friends (Garfield Pocket Books),1987,44,5,3,1986,1
jim davis,The 4th Garfield Treasury,1987,45,4.857142857142857,7,1987,0
jim davis,Garfield Swallows His Pride (Garfield (Numbered Paperback)),1987,46,3.75,4,1987,0
jim davis,Garfield Food for Thought/His 13th Book (Garfield (Numbered Paperback)),1987,47,1.3333333333333333,6,1987,0
jim davis,Garfield Weighs in (Garfield (Numbered Paperback)),1988,48,3.6,5,1987,1
jim davis,Garfield Gains Weight (Garfield (Numbered Paperback)),1988,49,5,3,1988,0
jim davis,Garfield Bigger Than Life (Garfield (Numbered Paperback)),1988,50,4.5,2,1988,0
jim davis,Garfield Goes Hollywood,1988,51,4.25,4,1988,0
jim davis,Garfield Pocket Books: Plays It Again (Garfield Pocket Books),1988,52,8,1,1988,0
jim davis,"The Great Christmas Contest: U.S. Acres, Book 1",1988,53,4,2,1988,0
jim davis,Garfield Rolls on (Garfield (Numbered Paperback)),1988,54,4.25,16,1988,0
jim davis,Garfield's Night Before Christmas,1988,55,0,1,1988,0
jim davis,Garfield Book of Cat Names,1988,56,2,2,1988,0
jim davis,Garfield Rounds Out (Garfield (Numbered Paperback)),1988,57,3.75,12,1988,0
jim davis,Garfield's Thanksgiving,1988,58,1.5,4,1988,0
jim davis,Garfield Worldwide (Garfield (Numbered Paperback)),1988,59,2.8333333333333335,6,1988,0
jim davis,Garfield Chews the Fat (Garfield (Numbered Paperback)),1989,60,2.5,4,1988,1
jim davis,Garfield the Big Star (Golden Look-Look Books),1989,61,2.75,4,1989,0
jim davis,Garfield Furry Tale,1989,62,0,1,1989,0
jim davis,Garfield Tips the Scales (Garfield (Numbered Paperback)),1989,63,3.3333333333333335,3,1989,0
jim davis,"Happy Birthday, Garfield! (Golden Book for Early Childhood)",1989,64,0,1,1989,0
jim davis,Garfield Presents...Babes and Bullets,1989,65,0,1,1989,0
jim davis,Garfield Pocket Books: Happy Landings (Garfield Pocket Books),1989,66,8,1,1989,0
jim davis,"Happy Birthday, Garfield (Golden Super Shape)",1989,67,0,2,1989,0
jim davis,Garfield Pocket Books: On Top of the World (Garfield Pocket Books),1989,68,8,1,1989,0
jim davis,"Garfield Goes to Waist, No 18 (Garfield (Numbered Paperback))",1990,69,3,5,1989,1
jim davis,The Second Garfield Treasury,1990,70,6,1,1990,0
jim davis,Garfield on the Farm,1990,71,7.5,2,1990,0
jim davis,"Garfield, Bd.15, Garfield kommt rum",1990,72,0,2,1990,0
jim davis,Garfield Landscape Books: The Irresistible (Garfield Landscape Books),1990,73,8,1,1990,0
jim davis,Garfield Landscape Books: The All-round Sports Star (Garfield Landscape Books),1990,74,0,1,1990,0
jim davis,"Garfield Hangs Out (Book, No. 19)",1990,75,1,5,1990,0
jim davis,Garfield Landscape Books: This Is Your Life (Garfield Landscape Books),1990,76,4.5,2,1990,0
jim davis,Garfield Landscape Books: The Incurable Romantic (Garfield Landscape Books),1990,77,0,1,1990,0
jim davis,"Garfield: The Me Book : A Guide to Superiority : How to Get It, Use It and Keep It",1990,78,0,2,1990,0
jim davis,A Garfield Christmas,1990,79,2.6,5,1990,0
jim davis,The Fourth Garfield Treasury,1990,80,0,1,1990,0
jim davis,Garfield Pocket Books: Going Places (Garfield Pocket Books),1990,81,5,1,1990,0
jim davis,Garfield Pocket Books: Le Magnifique! (Garfield Pocket Books),1990,82,5,1,1990,0
jim davis,Garfield's Feline Fantasies,1990,83,6.666666666666667,3,1990,0
jim davis,"Garfield Takes Up Space (Garfield, No 20)",1991,84,3.4444444444444446,9,1990,1
jim davis,Sixth Garfield Treasury,1991,85,0,2,1991,0
jim davis,"Garfield Says a Mouthful, No 21 (Garfield (Numbered Paperback))",1991,86,3,4,1991,0
jim davis,Garfield's Tale/Myst,1991,87,0,1,1991,0
jim davis,Garfield Crosswords,1991,88,0,2,1991,0
jim davis,"Garfield Be My Valentine (Postcard Book, No 4)",1991,89,0,1,1991,0
jim davis,Garfield by the Pound (Garfield (Numbered Paperback)),1992,90,0,2,1991,1
jim davis,The Fifth Garfield Treasury,1992,91,5.6,5,1992,0
jim davis,Garfield's Longest Cat Nap,1992,92,7.5,2,1992,0
jim davis,Garfield's Ghost Stories,1992,93,0,1,1992,0
jim davis,Garfield Keeps His Chins Up (Garfield (Numbered Paperback)),1992,94,0,1,1992,0
jim davis,Garfield Pocket Books: Great Impressions (Garfield Pocket Books),1992,95,4,2,1992,0
jim davis,Garfield Fat Cat: Garfield at Large/Garfield Gains Weight/Garfield Bigger Than Life (Garfield Fat Cat Three Pack),1993,96,3.6,5,1992,1
jim davis,Garfield Takes His Licks (Garfield (Numbered Paperback)),1993,97,5.666666666666667,3,1993,0
jim davis,Garfield Hits the Big Time (Garfield (Numbered Paperback)),1993,98,3.3333333333333335,3,1993,0
jim davis,The 7th Garfield Treasury,1993,99,7,4,1993,0
jim davis,"Garfield's Insults, Put-Downs &amp; Slams",1994,100,2.875,8,1993,1
jim davis,Garfield's Big Fat Scary Joke Book,1994,101,0,1,1994,0
jim davis,Garfield's Furry Tales,1994,102,0,1,1994,0
jim davis,Garfield's Big Fat Hairy Joke Book,1994,103,0,3,1994,0
jim davis,Garfield Fat Cat 3 Pack/3 Books in 1 Volume (Garfield Fat Cat Three Pack),1994,104,5,3,1994,0
jim davis,Garfield Pulls His Weight (No. 26),1994,105,2.857142857142857,7,1994,0
jim davis,Garfield's Son of Big Fat Hairy Jokes,1994,106,0,2,1994,0
jim davis,Garfield Dishes It Out (Garfield (Numbered Paperback)),1995,107,4.4,5,1994,1
jim davis,Garfield Pocket Books: Wave Rebel (Garfield Pocket Books),1995,108,0,2,1995,0
jim davis,The Third Garfield Fat Cat 3-Pack (Garfield Fat Cat Three Pack),1995,109,3.5,2,1995,0
jim davis,The Fourth Garfield Fat Cat Three Pack,1995,110,7,3,1995,0
jim davis,"Life in the Fat Lane (Garfield, No 28)",1995,111,0,2,1995,0
jim davis,Garfield Fat Cat 3 Pack (Vols 13-15),1996,112,0,1,1995,1
jim davis, Garfield Bigger and Better (Garfield (Numbered Paperback)),1996,113,3.5,2,1996,0
jim davis,The Ninth Garfield Treasury,1997,114,7.5,2,1996,1
jim davis,Garfield's Book of Jokes and Riddles,1997,115,0,1,1997,0
jim davis,Garfield Hams It Up (Garfield (Numbered Paperback)),1997,116,6.333333333333333,3,1997,0
jim davis,Garfield Pocket Books: On the Right Track (Garfield Pocket Books),1997,117,7,2,1997,0
jim davis,Garfield Thinks Big (Garfield (Numbered Paperback)),1997,118,5,6,1997,0
jim davis,Garfield Goes to Disobedience School,1997,119,3.5,2,1997,0
jim davis,The Ninth Garfield Fat Cat 3-Pack (Garfield Fat Cat Three Pack),1998,120,10,1,1997,1
jim davis,Garfield Pocket Books: Garfield the Irresistible (Garfield Pocket Books),1998,121,7,1,1998,0
jim davis,"Garfield and the Teacher Creature (Planet Reader, Chapter Book)",1998,122,2.5,4,1998,0
jim davis,"Garfield Gets Around (Garfield Games &amp; Sticker Fun, #4)",1998,123,0,1,1998,0
jim davis,Garfield Fat Cat 3 Pack (Garfield Fat Cat Three Pack),1998,124,1.5,2,1998,0
jim davis,Garfield Throws His Weight Around (Garfield (Numbered Paperback)),1998,125,2.6666666666666665,3,1998,0
jim davis,"Garfield and the Beast in the Basement (Planet Reader, Chapter Book)",1998,126,0,2,1998,0
jim davis,The Eleventh Garfield Fat Cat (Garfield Fat Cat Three Pack),1999,127,5.714285714285714,7,1998,1
jim davis,The Tenth Garfield Fat Cat 3-Pack: Garfield Life in the Fat Lane (#28); Garfield Tons of Fun (#29); Garfield  Bigger and Better (#30) (Garfield Fat Cat Three Pack),1999,128,4.5,2,1999,0
jim davis,Garfield: Life to the Fullest (Garfield (Numbered Paperback)),1999,129,8,2,1999,0
jim davis,Breitet Sich Aus (Garfield (German Titles)),1999,130,8,1,1999,0
jim davis,Garfield Takes the Cake (Garfield (Numbered Hardcover)),1999,131,0,1,1999,0
jim davis,"Attack of the Lethal Lizards (Garfield's - Pet Force, Book 5)",1999,132,5,1,1999,0
jim davis,Garfield Feeds the Kitty (Garfield (Numbered Paperback)),1999,133,10,1,1999,0
jim davis,Garfield's Big Book of Excellent Excuses,2000,134,0,1,1999,1
jim davis,Garfield in the Mood for Food,2000,135,6.75,4,2000,0
jim davis,Garfield Hogs the Spotlight (Garfield (Numbered Paperback)),2000,136,0,1,2000,0
jim davis,"1,000 Marbles: A Little Something About Precious Time",2001,137,2,5,2000,1
jim davis,The Twelfth Garfield Fat Cat 3-Pack (Garfield Fat Cat Three Pack),2001,138,6,1,2001,0
jim davis,"Garfield at Large (Davis, Jim. Garfield Classics.)",2001,139,10,1,2001,0
jim davis,"Garfield Gains Weight (Davis, Jim. Garfield Classics, 2.)",2001,140,10,1,2001,0
jim davis,Garfield Weighs In: His Fourth Book,2002,141,0,1,2001,1
jim davis,In Dog Years I'd Be Dead: Garfield at 25,2002,142,10,1,2002,0
jim davis,Garfield's Sumo Beach Bellyball (Garfield Extreme),2002,143,0,1,2002,0
jim davis,K-Niner : Dog of Doom (Garfield's Pet Force Book 3),2002,144,0,1,2002,0
jim davis,"Garfield: Bigger Than Life (Garfield, 3)",2002,145,10,1,2002,0
jim davis,Garfield Eats His Heart Out (Garfield (Numbered Paperback)),2003,146,0,1,2002,1
jim davis,Garfield Eats Crow (Garfield),2003,147,2.25,4,2003,0
jim davis,Garfield Sits Around the House,2003,148,0,1,2003,0
jim haskins,Black Eagles: African Americans in Aviation,1997,2,10,1,1994,3
jim haskins,Get on Board: The Story of the Underground Railroad,1997,3,0,1,1997,0
jim kraus,"The Quest (Circle of Destiny, Book 4)",2002,2,0,1,2000,2
jim kraus,The Unfolding: Gods Amazing Grace Unfolds in Story (MacKenzie Street),2003,3,0,1,2002,1
jim lawrence,The Gingerbread Boy (Honey Bear Books),1987,2,3.5,2,1986,1
jim lawrence,Annie's Angel,2000,3,0,1,1987,13
jim lawrence,A Killing in Carter Country,2001,4,10,1,2000,1
jim lawrence,The Surrounding: A Spectral Mystery,2003,5,10,1,2001,2
jim lawrence,The Surrounding,2003,6,0,2,2003,0
jim murphy,The call of the wolves,1989,2,8,1,1984,5
jim murphy,The Last Dinosaur,1991,3,0,1,1989,2
jim murphy,"West to a Land of Plenty: The Diary of Teresa Angelino Viscardi, New York to Idaho Territory, 1883 (Dear America)",1992,4,0,7,1991,1
jim murphy,Night Terrors,1993,5,0,1,1992,1
jim murphy,Night Terrors,1994,6,0,4,1993,1
jim murphy,Across America on an Emigrant Train,1995,7,0,3,1994,1
jim murphy,"The Journal of James Edmond Pease: A Civil War Union Soldier, Virginia, 1863 (My Name is America)",1998,8,6,3,1995,3
jim murphy,"My Face to the Wind: The Diary of Sarah Jane Price, a Prairie Teacher, Broken Bow, Nebraska, 1881 (Dear America)",2001,9,3,3,1998,3
jim patton,Dying for Dana,2003,2,9,1,2000,3
jimmy guterman,Slipped Discs...the Worst Rock 'n' Roll Records of All Time,1991,2,0,1,1991,0
jimmy santiago baca,A Place to Stand: The Making of a Poet,2002,2,9,1,1992,10
jimmy santiago baca,The Importance of a Piece of Paper,2004,3,4,1,2002,2
jo ann algermissen,"Hank'S Woman (Silhouette Desire, No 318)",1986,2,0,1,1984,2
jo ann algermissen,"Serendipity Samantha (Silhouette Desire, No 300)",1986,3,0,2,1986,0
jo ann algermissen,"Purple Diamonds (Silhouette Special Edition, No. 374)",1987,4,0,1,1986,1
jo ann algermissen,Blue Emeralds,1988,5,0,1,1987,1
jo ann algermissen,Marry - Me Christmas (Harlequin Yours Truly),1996,6,2.25,4,1988,8
jo beverley,Lord of My Heart,1992,2,4,2,1989,3
jo beverley,An Unwilling Bride,1992,3,8,1,1992,0
jo beverley,Christmas Angel,1992,4,4,1,1992,0
jo beverley,My Lady Notorious,1993,5,0,1,1992,1
jo beverley,Forbidden,1995,6,0,1,1993,2
jo beverley,Tempting Fortune,1995,7,10,1,1995,0
jo beverley,Dangerous Joy,1995,8,6,1,1995,0
jo beverley,The Shattered Rose,1996,9,2.6666666666666665,3,1995,1
jo beverley,Something Wicked,1997,10,0.7,10,1996,1
jo beverley,Forbidden Magic,1998,11,3.111111111111111,18,1997,1
jo beverley,Lord of Midnight (Topaz Historical Romance),1998,12,0,5,1998,0
jo beverley,An Arranged Marriage (Zebra Historical Romance),1999,13,3.2,10,1998,1
jo beverley,Brides Of Christmas,1999,14,0.6153846153846154,13,1999,0
jo beverley,Star of Wonder,1999,15,0,4,1999,0
jo beverley,Secrets of the Night,1999,16,1.8888888888888888,9,1999,0
jo beverley,Devilish,2000,17,1.2727272727272727,11,1999,1
jo beverley,An Unwilling Bride,2000,18,2.473684210526316,19,2000,0
jo beverley,In Praise of Younger Men (Signet Historical Romance),2001,19,1,5,2000,1
jo beverley,The Devil's Heiress,2001,20,2.5,26,2001,0
jo beverley,The Dragon's Bride,2001,21,4.5,14,2001,0
jo beverley,Christmas Angel,2001,22,1.6666666666666667,12,2001,0
jo beverley,Tempting Fortune,2002,23,2.125,16,2001,1
jo beverley,Lord of My Heart,2002,24,1.2857142857142858,7,2002,0
jo beverley,My Lady Notorious,2002,25,1.4285714285714286,14,2002,0
jo beverley,Hazard,2002,26,1.608695652173913,23,2002,0
jo beverley,Winter Fire,2003,27,2.3333333333333335,6,2002,1
jo beverley,Dark Champion,2003,28,1.5,8,2003,0
jo beverley,St. Raven,2003,29,2.875,16,2003,0
jo beverley,Forbidden (Zebra Historical Romance),2003,30,1.7,10,2003,0
jo beverley,Irresistible Forces,2004,31,5.25,4,2003,1
jo beverley,Secrets of the Night,2004,32,0.75,4,2004,0
jo beverley,Skylark,2004,33,4,6,2004,0
joan baez,And A Voice to Sing With: A Memoir,1989,2,0.8333333333333334,6,1988,1
joan chase,The Evening Wolves: A Novel,1989,2,0,3,1984,5
joan chase,The Evening Wolves,1991,3,0,1,1989,2
joan chase,During the Reign of the Queen of Persia,1996,4,0,3,1991,5
joan e. pickart,Secrets of Autumn (Loveswept #162),1986,2,0,1,1984,2
joan e. pickart,Illusions,1987,3,0,2,1986,1
joan e. pickart,Tattered Wings,1988,4,0,1,1987,1
joan e. pickart,Family Secrets (Lovestruck),1989,5,0,1,1988,1
joan eckstein,Fun With Growing Things (Avon Camelot Books (Paperback)),1991,2,2.3333333333333335,3,1990,1
joan elliot pickart,"Rancher And The Amnesiac Bride (Follow That Baby!) (Silhouette Special Edition , No 1204)",1998,2,1.6666666666666667,3,1997,1
joan elliot pickart,"Most Eligible M D (The Bachelor Bet) (Silhouette Special Edition, 1262)",1999,3,0,1,1998,1
joan elliot pickart,"Man ... Mercenary ... Monarch (Royally Wed) (Special Edition, 1303)",2000,4,2,2,1999,1
joan elliot pickart,"Plain Jane Macallister  (The Baby Bet:  The Macallister Family (Silhouette Desire, No. 1462)",2002,5,0,4,2000,2
joan elliot pickart,"Tall, Dark and Irresistible  (The Baby Bet: McAllister's Gifts)",2002,6,2.8,5,2002,0
joan elliot pickart,"The Royal Macallister  (The Baby Bet:  Macallister's Gifts) (Silhouette Special Edition, No. 1477)",2002,7,1.2,15,2002,0
joan elliot pickart,The Marrying MacAllister : The Baby Bet:  MacAllisters Gifts (Special Edition),2003,8,0,4,2002,1
joan elliot pickart,Body of Evidence,2003,9,0,4,2003,0
joan elliot pickart,Accidental Family : The Baby Bet: Macallister's Gifts (Special Edition),2004,10,0,1,2003,1
joan fuster,Ser Joan Fuster: Antologia de textos fusterians (Els Nostres autors),1991,2,2.5,2,1978,13
joan johnston,Fit To Be Tied,1988,2,0,1,1986,2
joan johnston,"Frontier Woman : Frontier Woman (Sisters of the Lone Star, Vol 1)",1988,3,1.3333333333333333,6,1988,0
joan johnston,"COMANCHE WOMAN : COMANCHE WOMAN (Sisters of Lone Star, Vol II)",1989,4,0,3,1988,1
joan johnston,"Marriage By The Book (Desire, No 489)",1989,5,0,1,1989,0
joan johnston,Sweetwater Seduction,1990,6,3.5714285714285716,7,1989,1
joan johnston,"Wolf In Sheep'S Clothing (Harlequin Desire, No 658)",1991,7,0,3,1990,1
joan johnston,The Barefoot Bride,1991,8,0,4,1991,0
joan johnston,"Never Tease a Wolf (Silhouette Desire, No. 652)",1991,9,0,1,1991,0
joan johnston,"Honey And The Hired Hand (Silhouette Desire, No 746",1992,10,0,2,1991,1
joan johnston,"Cowboy And The Princess (Silhouette Desire, No 785)",1993,11,0,1,1992,1
joan johnston,"Wrangler And The Rich Girl (Silhouette Desire, No 791)",1993,12,0,1,1993,0
joan johnston,"Rancher And The Runaway Bride (Silhouette Desire, No 779)",1993,13,0,3,1993,0
joan johnston,Outlaw's Bride,1993,14,0,3,1993,0
joan johnston,Kid Calhoun,1993,15,3.4285714285714284,7,1993,0
joan johnston,"Unforgiving Bride (Hawk'S Way) (Silhouette Desire, No 878)",1994,16,0,1,1993,1
joan johnston,"Cowboy Takes A Wife (Hawk'S Way) (Silhouette Desire, No 842)",1994,17,0,2,1994,0
joan johnston,"Headstrong Bride (Hawk'S Way) (Silhouette Desire, No 896)",1994,18,0,3,1994,0
joan johnston,Maverick Heart,1995,19,4.5,2,1994,1
joan johnston,"Disobedient Bride (Man Of The Month, Hawk'S Way) (Silhouette Desire No 937)",1995,20,1.75,4,1995,0
joan johnston,The Inheritance,1995,21,1.75,4,1995,0
joan johnston,I Promise,1996,22,0,3,1995,1
joan johnston,"Temporary Groom (Hawk'S Way) (Silhouette Desire, No 1004)",1996,23,0,1,1996,0
joan johnston,Captive,1996,24,2.25,8,1996,0
joan johnston,Virgin Groom  (Hawk'S Way),1997,25,4,7,1996,1
joan johnston,After the Kiss,1997,26,5,2,1997,0
joan johnston,Marriage By The Book  (Florida) (Born in the USA),1997,27,0.8888888888888888,9,1997,0
joan johnston,Heartbeat,1997,28,2.6666666666666665,6,1997,0
joan johnston,The Bodyguard,1998,29,2.25,12,1997,1
joan johnston,Hawk'S Way: The Substitute Groom (Silhouette Promo),1998,30,5.333333333333333,3,1998,0
joan johnston,Spouse For Hire  (By Request) (By Request),1998,31,0,1,1998,0
joan johnston,Fit To Be Tied (Men At Work) (Men at Work),1998,32,0,1,1998,0
joan johnston,The Bridegroom,1999,33,2.8518518518518516,27,1998,1
joan johnston,Little Time In Texas,2000,34,0,2,1999,1
joan johnston,COWBOY,2000,35,2.967741935483871,31,2000,0
joan johnston,Hawk'S Way Bachelors (Trade Paperback) (Silhouette Promo),2000,36,0,1,2000,0
joan johnston,Frontier Woman,2001,37,1.2857142857142858,21,2000,1
joan johnston,The Texan,2001,38,1.2727272727272727,22,2001,0
joan johnston,Hawk'S Way Rogues,2001,39,10,1,2001,0
joan johnston,Hawk'S Way Bride,2001,40,2.1666666666666665,6,2001,0
joan johnston,Never Tease A Wolf,2001,41,3.1666666666666665,6,2001,0
joan johnston,Harlequin Special #4,2001,42,0,4,2001,0
joan johnston,Sisters Found,2002,43,1.6610169491525424,59,2001,1
joan johnston,A Wolf In Sheep's Clothing,2002,44,1.6470588235294117,17,2002,0
joan johnston,Hawk's Way Grooms,2002,45,0,3,2002,0
joan johnston,Comanche Woman,2002,46,1.85,20,2002,0
joan johnston,Silhouette Ncp - Volume 5,2002,47,2,3,2002,0
joan johnston,The Loner,2002,48,0,1,2002,0
joan johnston,The Loner,2002,49,2.09375,32,2002,0
joan johnston,Colter's Wife,2003,50,2.1666666666666665,18,2002,1
joan johnston,Texas Woman,2003,51,2.230769230769231,13,2003,0
joan johnston,Marriage by the Book,2003,52,1.6666666666666667,9,2003,0
joan johnston,The Price: A Novel,2003,53,4.25,4,2003,0
joan johnston,The Price : A Novel,2004,54,0.9090909090909091,11,2003,1
joan johnston,The Rivals (A Bitter Creek Novel),2004,55,10,1,2004,0
joan jonker,Sweet Rosie O'Grady,1997,2,0,1,1986,11
joan joseph,Now Is the Hour,1985,2,0,1,1981,4
joan m. erikson,Legacies: Prometheus Orpheus Socrates,1993,2,2,1,1991,2
joan peyser,Bernstein,1988,2,2.6666666666666665,3,1987,1
joan price,Truth Is a Bright Star: A Hopi Adventure (Hopi Adventure),1997,2,5,1,1982,15
joan rawlins biggar,Danger at Half Moon Lake (Adventure Quest Ser),1991,2,0,1,1990,1
joan rawlins biggar,"Mystery at Camp Galena (Biggar, Joan Rawlins, Megan Parnell Mysteries, 2.)",1997,3,0,3,1991,6
joan stimson,Rhyming Rabbit,1989,2,0,1,1989,0
joan stimson,Animals: Stories for Under Fives (Series 922),1992,3,0,3,1989,3
joan stimson,Favourite Tales: The Magic Porridge Pot (Old Favourite Tales),1993,4,5,1,1992,1
joan stimson,Animal Stories for Under Fives,1994,5,0,2,1993,1
joan stimson,Worried Arthur : A Christmas Story,1994,6,0,1,1994,0
joan stimson,"Swim Polar Bear, Swim!",1996,7,0,1,1994,2
joan stimson,Brilliant Little Elephant (Little Animal Stories),1998,8,4.333333333333333,3,1996,2
joan stimson,Duck Stories for 2 Year Olds (Animal Funtime),1998,9,0,1,1998,0
joan stimson,Cheeky Little Kitten (Little Animal Stories),1998,10,0,1,1998,0
joan w. brown,Let Me Love Again,1984,2,8,1,1984,0
joan weigall lindsay,Picnic at Hanging Rock,1987,2,9,1,1976,11
"joan, ph.d. borysenko",A Woman's Journey to God,2001,2,5.333333333333333,3,2001,0
joanna hines,Improvising Carla,2001,2,4,3,1993,8
joanna hines,Improvising Carla,2002,3,4.5,2,2001,1
joanna m lund,Dessert Every Night!,1998,2,6,1,1997,1
joanna scott,High Risk (Silhouette Special Edition No. 272),1985,2,0,1,1982,3
joanna scott,Arrogance,1991,3,5,2,1985,6
joanna scott,The Closest Possible Union,1996,4,5,1,1991,5
joanna scott,The Manikin: A Novel,1998,5,0,3,1996,2
joanna scott,Make Believe,2000,6,1,5,1998,2
joanna scott,Make Believe : A Novel,2001,7,0,3,2000,1
joanna scott,The Manikin: A Novel,2002,8,0,1,2001,1
joanna scott,Tourmaline: A Novel,2003,9,0,1,2002,1
joanne barkan,My Cooking Spoon,1989,2,0,1,1989,0
joanne barkan,My Spatula (My First Kitchen Gadget Books),1989,3,0,1,1989,0
joanne barkan,My Cooking Pot,1989,4,0,1,1989,0
joanne barkan,Whiskerville Bake Shop (Whiskerville Board Books),1990,5,0,1,1989,1
joanne barkan,A Very Scary Haunted House (Glows in the Dark),1991,6,2,4,1990,1
joanne barkan,A Very Merry Santa Claus Story (Sparkleand Glow Books),1992,7,6,1,1991,1
joanne barkan,A Very Scary Ghost Story (Cartwheel),1992,8,5,3,1992,0
joanne barkan,That Fat Hat (Cartwheel Books),1992,9,8,1,1992,0
joanne barkan,A Very Scary Witch Story,1992,10,3,2,1992,0
joanne barkan,The magic carpet's secret (Disney's Aladdin series),1993,11,2.3333333333333335,3,1992,1
joanne barkan,The Krystal Princess and the Grand Contest (Krystal Princess),1994,12,0,1,1993,1
joanne barkan,Tooth Fairy Magic (Sparkle-and-Glow Books),1995,13,0,3,1994,1
joanne barkan,Velveteen Rabbit (Cherished Fairy Tales),1995,14,0,1,1995,0
joanne barkan,Big Fire Trucks,1996,15,8,1,1995,1
joanne barkan,The Strangest Halloween (Trick-or-Treat Glow-in-the-Dark Books),1996,16,7,1,1996,0
joanne barkan,The Switching Hour (Real Monsters),1996,17,0,2,1996,0
joanne barkan,Help! It's Halloween! (Trick-or-Treat Glow-in-the-Dark Books),1996,18,7,1,1996,0
joanne barkan,Zeena's Cat (Trick-or-Treat Glow-in-the-Dark Books),1997,19,0,1,1996,1
joanne barkan,The Witch's Hat (Trick-or-Treat Glow-in-the-Dark Books),1997,20,8,1,1997,0
joanne barkan,A Pup in King Arthur's Court (Adventure of Wishbone),1998,21,1.4,5,1997,1
joanne barkan,Very Scary Jack O Lantern (Glows in the Dark),1999,22,5,1,1998,1
joanne harris,Chocolat (Thorndike Large Print Basic Series),1999,2,0,3,1999,0
joanne harris,Chocolat: A Novel,1999,3,3.3846153846153846,13,1999,0
joanne harris,Blackberry Wine: A Novel,2000,4,3.076923076923077,13,1999,1
joanne harris,Chocolat,2000,5,3.8035714285714284,112,2000,0
joanne harris,Chocolat,2000,6,2.935251798561151,139,2000,0
joanne harris,Chocolat,2000,7,3.769230769230769,52,2000,0
joanne harris,Blackberry Wine,2000,8,0,1,2000,0
joanne harris,Chocolate,2000,9,1.6666666666666667,3,2000,0
joanne harris,Blackberry Wine,2001,10,3.5694444444444446,72,2000,1
joanne harris,Five Quarters of the Orange,2001,11,4,2,2001,0
joanne harris,Blackberry Wine : A Novel,2001,12,3.6363636363636362,44,2001,0
joanne harris,Five Quarters of the Orange,2001,13,3.912280701754386,57,2001,0
joanne harris,Chocolat. Das Buch zum Film.,2001,14,2.3333333333333335,6,2001,0
joanne harris,Chocolat,2001,15,3.1666666666666665,36,2001,0
joanne harris,Coastliners : A Novel,2002,16,7,1,2001,1
joanne harris,Coastliners : A Novel,2002,17,2.7666666666666666,30,2002,0
joanne harris,Chocolat.,2002,18,3.3333333333333335,3,2002,0
joanne harris,Wie Wilder Wein.,2002,19,8,1,2002,0
joanne harris,FÃ?Â¼nf Viertel einer Orange.,2002,20,1.6,5,2002,0
joanne harris,Five Quarters of the Orange,2002,21,3.439189189189189,148,2002,0
joanne harris,Chocolat. Das Buch zum Film.,2003,22,2.4285714285714284,7,2002,1
joanne harris,My French Kitchen : A Book of 120 Treasured Recipes,2003,23,10,1,2003,0
joanne harris,Voleurs de plage,2003,24,8,1,2003,0
joanne harris,Coastliners : A Novel,2003,25,2.193548387096774,31,2003,0
joanne harris,"Holy Fools : A Novel (Harris, Joanne)",2004,26,3.129032258064516,31,2003,1
joanne harris,Jigs &amp; Reels : Stories,2004,27,0,6,2004,0
joanne harris,Holy Fools : A Novel,2004,28,0,1,2004,0
joanne wallace,Dress to Fit Your Personality,1989,2,0,1,1978,11
jocelyn carew,Crown of Passion,1980,2,0,1,1979,1
jodi picoult,Harvesting the Heart,1995,2,1.8888888888888888,18,1992,3
jodi picoult,Picture Perfect,1995,3,0,1,1995,0
jodi picoult,Picture Perfect,1996,4,2.5,4,1995,1
jodi picoult,Mercy (G K Hall Large Print Book Series (Cloth)),1997,5,5,2,1996,1
jodi picoult,The Pact : A Love Story,1998,6,2.857142857142857,21,1997,1
jodi picoult,Keeping Faith : A Novel,1999,7,3.6923076923076925,13,1998,1
jodi picoult,The Pact: A Love Story,1999,8,4.253012048192771,83,1999,0
jodi picoult,Keeping Faith : A Novel,2000,9,4.229166666666667,48,1999,1
jodi picoult,Plain Truth,2000,10,3.4,25,2000,0
jodi picoult,Bis ans Ende aller Tage. Die Geschichte einer Liebe.,2000,11,0,1,2000,0
jodi picoult,Salem Falls,2001,12,3,16,2000,1
jodi picoult,Songs of the Humpback Whale : A Novel in Five Voices,2001,13,2.8333333333333335,24,2001,0
jodi picoult,Plain Truth,2001,14,4.559523809523809,84,2001,0
jodi picoult,Salem Falls,2001,15,0,1,2001,0
jodi picoult,Mercy,2001,16,1.40625,32,2001,0
jodi picoult,Picture Perfect,2002,17,1.9130434782608696,23,2001,1
jodi picoult,Auf den zweiten Blick. Roman.,2002,18,0,1,2002,0
jodi picoult,Salem Falls,2002,19,3.2285714285714286,35,2002,0
jodi picoult,Perfect Match : A Novel,2002,20,3.3,10,2002,0
jodi picoult,Perfect Match: A Novel,2003,21,1.911764705882353,34,2002,1
jodi picoult,Second Glance: A Novel,2003,22,3.5714285714285716,14,2003,0
jodi picoult,"My Sister's Keeper : A Novel (Picoult, Jodi)",2004,23,4.883720930232558,43,2003,1
jodi picoult,Second Glance : A Novel,2004,24,2.7333333333333334,15,2004,0
jodie rhodes,Winners and Losers (Jove Book),1982,2,0,1,1980,2
jody duncan,The Making of The X-Files Film,1998,2,5,1,1996,2
jody powell,The Other Side of the Story,1986,2,9,1,1984,2
joe clifford faust,Precious Cargo (Book 2 of Angel's Luck),1989,2,2.3333333333333335,3,1989,0
joe clifford faust,Ferman's Devils,1996,3,3,2,1989,7
joe famularo,The Joy of Pasta (Barron's Educational Series),1989,2,0,2,1985,4
joe famularo,Celebrations: Sumptuous Meals for Festive Occasions,1993,3,9,1,1989,4
joe franklin,Joe Franklin's Great Entertainment Trivia Game,2002,2,0,2,1983,19
joe kelly,"Dads and Daughters: How to Inspire, Understand, and Support Your Daughter When She's Growing Up So Fast",2002,2,8,1,2001,1
joe kurmaskie,Riding Outside the Lines: International Incidents and Other Misadventures With the Metal Cowboy,2003,2,4.5,2,2002,1
joe l. hensley,Robak's Fire (Donald Robak Mysteries),1986,2,0,1,1986,0
joe l. hensley,Grim City,1994,3,0,1,1986,8
joe l. hensley,Loose Coins (Sears Mysteries),2000,4,1.6666666666666667,3,1994,6
joe l. hensley,Robak in Black,2001,5,8,1,2000,1
joe l. wheeler,Christmas in My Heart: A Timeless Treasury of Heartwarming Stories,1996,2,8,1,1992,4
joe l. wheeler,Focus on the Family Presents Great Stories Remembered,1998,3,10,1,1996,2
joe l. wheeler,Great Stories Remembered  II: Focus on the Family (Great Stories),1998,4,0,1,1998,0
joe l. wheeler,Heart to Heart: Stories of Friendship,1999,5,0,1,1998,1
joe l. wheeler,Heart to Heart: Stories for Moms (Heart to Heart),2000,6,5,1,1999,1
joe l. wheeler,Christmas in My Heart (Christmas in My Heart Series #12),2003,7,0,1,2000,3
joe l. wheeler,Heart to Heart Stories for Teachers,2003,8,0,1,2003,0
joe matt,Fair Weather,2002,2,4.5,2,2001,1
joe matt,Peepshow,2003,3,10,1,2002,1
joe mcginnis,Blind Faith,1990,2,2,6,1984,6
joe nickell,Secrets of the Supernatural: Investigating the World's Occult Mysteries,1988,2,0,1,1987,1
joe nickell,"Mysterious Realms: Probing Paranormal, Historical, and Forensic Enigmas",1992,3,1.4,5,1988,4
joe nickell,"Looking for a Miracle: Weeping Icons, Relics, Stigmata, Visions &amp; Healing Cures",1993,4,4,2,1992,1
joe nickell,Psychic Sleuths: Esp and Sensational Cases,1994,5,0,1,1993,1
joe nickell,"Entities: Angels, Spirits, Demons, and Other Alien Beings",1995,6,0,1,1994,1
joe nickell,"Looking for a Miracle: Weeping Icons, Relics, Stigmata, Visions &amp; Healing Cures",1999,7,2.3333333333333335,3,1995,4
joe nickell,The Mystery Chronicles: More Real-Life X-Files,2004,8,4,1,1999,5
joe stahlkuppe,"Great Danes: Everything About Purchase, Care, Nutrition, Breeding, Behavior, and Training With 46 Color Photos",1994,2,4,1,1991,3
joe stahlkuppe,"American Pit Bull and Staffordshire Terriers: Everything About Purchase, Care, Nutrition, Breeding, Behavior, and Training (A Complet)",1995,3,5,1,1994,1
joe stahlkuppe,"Basset Hounds: Everything About Purchase, Care, Nutrition, Breeding Behavior, and Training (Complete Pet Owner's Manuals)",1997,4,10,1,1995,2
joe stahlkuppe,"Poodles: Everything About Purchase, Care, Nutrition, Breeding, Behavior, and Training (Complete Pet Owner's Manuals)",1997,5,0,1,1997,0
joe starita,Dull Knifes of Pine Ridge: A Lakota Odyssey,1996,2,1.25,4,1995,1
joe white,Lifetraining (Focus on the Family),1999,2,0,1,1998,1
joel achenbach,Why Things Are: The Big Picture (Big Picture Vol. 2),1993,2,0,3,1991,2
joel achenbach,Why Things Are &amp; Why Things Aren't,1996,3,2.5,6,1993,3
joel achenbach,It Looks Like a President Only Smaller: Trailing Campaign 2000,2001,4,5,1,1996,5
john  kaufeld,Access 2000 for Windows for Dummies,1999,2,0,1,1997,2
john  kaufeld,AOL for Dummies,2002,3,0,1,1999,3
john  kaufeld,Access 2003 for Dummies,2003,4,0,1,2002,1
john  neff,John Neff on Investing,2001,2,0,1,1999,2
john ashbery,Three Poems,1986,2,4.5,2,1985,1
john ashbery,"Reported Sightings: Art Chronicles, 1957-1987",1991,3,0,1,1986,5
john ashbery,And the Stars Were Shining,1995,4,7,1,1991,4
john ashbery,A Nest of Ninnies,1997,5,2,2,1995,2
john ashbery,April Galleons: Poems,1999,6,0,1,1997,2
john ashbery,Your Name Here: Poems,2000,7,0,1,1999,1
john ashbery,Autorretrato En Espejo Convexo,2001,8,10,1,2000,1
john bakeless,America As Seen by Its First Explorers: The Eyes of Discovery (Dover Language Books and Travel Guides),1989,2,0,1,1964,25
john bakeless,The Journals of Lewis and Clark (Signet Classics (Paperback)),2004,3,0,1,1989,15
john berryman,Collected Poems 1937-1971,1991,2,0,1,1982,9
john bianchi,Last of the Tree Ranchers,1986,2,8,2,1985,1
john bianchi,The Artist,1993,3,10,1,1986,7
john bianchi,Flight of the Space Quester (Bungalo Boys),1993,4,0,1,1993,0
john bourke,"The Snake Dance of the Moquis of Arizona: Being a Narrative of a Journey from Santa Fe, New Mexico, to the Villages of the Moqui Indians of Arizona",1984,2,9,1,1971,13
john bowen,Civil War Days: Everyday Life During the War Between the States,1988,2,3.5,2,1988,0
john bowen,Americas Living Past,1990,3,0,1,1988,2
john bowen,"Adventuring in the Chesapeake Bay Area: The Sierra Club Travel Guide to the Tidewater Country of Maryland, Virginia, and Washington, D.C., from Baltimore to the Virginia Capes (Sierra Club Adventure Travel Guides)",1990,4,8,1,1990,0
john brindley,Changing Emma,2002,2,5,1,2000,2
john brindley,Amy Peppercorn,2003,3,8,1,2002,1
john bryson,Evil Angels (Cry in the Dark Movie Title),1988,2,0,2,1987,1
john bryson,The Private World of Katharine Hepburn,1990,3,5,1,1988,2
john bunyan,Pilgrims Progress: In Today's English,1964,2,0,1,1959,5
john bunyan,Pilgrim's Progress,1979,3,0,1,1964,15
john bunyan,The Pilgrim's Progress,1980,4,0,1,1979,1
john bunyan,The Pilgrim's Progress,1981,5,0,1,1980,1
john bunyan,Pilgrims Progress,1982,6,10,1,1981,1
john bunyan,The Pilgrim's Progress (The World's Classics),1984,7,3.5,2,1982,2
john bunyan,Pilgrim's Progress,1985,8,2.3333333333333335,3,1984,1
john bunyan,Pilgrim's Progress (Moody Classics),1985,9,0,1,1985,0
john bunyan,Grace Abounding to the Chief of Sinners (Penguin Classics),1987,10,4,1,1985,2
john bunyan,The Pilgrim's Progress in the Allegory of a Dream,1991,11,0,1,1987,4
john bunyan,Pilgrim's Progress,1991,12,0,1,1991,0
john bunyan,The Pilgrim's Progress (Illustrated Christian Classics Series),1992,13,8,1,1991,1
john bunyan,Pilgrim's Progress,1993,14,4,2,1992,1
john bunyan,Pilgrim's Progress: A Retelling,1994,15,10,1,1993,1
john bunyan,The Pilgrim's Progress (Oxford World's Classics),1998,16,0,1,1994,4
john bunyan,The Pilgrim's Progress,1999,17,3,2,1998,1
john bunyan,The Pilgrims Progress (Value Book),2000,18,0,1,1999,1
john bunyan,The Pilgrim's Progress (Dover Thrift Editions),2003,19,0,1,2000,3
john burdett,The Last Six Million Seconds: A Thriller,1997,2,0,2,1996,1
john burdett,Bangkok 8,2003,3,2.923076923076923,13,1997,6
john burdett,Bangkok 8 (Vintage),2004,4,8,1,2003,1
john butterfield,What Is Dungeons and Dragons? (Puffin Adventure Gamebooks),1982,2,0,2,1982,0
john butterfield,What Is Dungeons and Dragons?,1984,3,0,2,1982,2
john butterfield,At the Court of King Minos (Puffin Adventure Gamebooks),1985,4,0,1,1984,1
john butterfield,Return of the Wanderer (Puffin Adventure Gamebooks),1986,5,0,4,1985,1
john c. ryan,Seven Wonders: Everyday Things for a Healthier Planet,1999,2,4.5,2,1997,2
john c. tucker,May God Have Mercy : A True Story of Crime and Punishment,1998,2,0,1,1997,1
john carter,Sex and Rockets: The Occult World of Jack Parsons,2000,2,8,2,1995,5
john cleland,Fanny Hill or Memoirs of a Woman of Pleasure (Penguin Classics),1986,2,2.5,4,1985,1
john cleland,Memoirs of Fanny Hill,1987,3,6,1,1986,1
john cleland,Fanny Hill: Memoirs of a Woman of Pleasure,1990,4,0,1,1987,3
john cleland,Fanny Hill (Penguin Popular Classics),1994,5,0,2,1990,4
john cleland,Memoirs of a Woman of Pleasure (Oxford World's Classics),1999,6,0,1,1994,5
john cleland,"Fanny Hill Or, Memoirs of a Woman of Pleasure (Modern Library Classics)",2001,7,7,2,1999,2
john cooney,Acts of Contrition,1991,2,0,4,1986,5
john coston,"Sleep My Child, Forever (Onyx True Crime)",1995,2,2.6,5,1992,3
john cronin,The RIVERKEEPERS: Two Activists Fight to Reclaim Our Environment as a Basic Human Right,1999,2,3,3,1998,1
john crosby,Take No Prisoners,1985,2,0,3,1984,1
john crosby,Contract on the President,1986,3,2,3,1985,1
john crosby,The Family Worth,1987,4,0,1,1986,1
john crowley,"Little, Big",1981,2,0,2,1981,0
john crowley,Engine Summer,1983,3,0,1,1981,2
john crowley,"Little, Big",1983,4,0.42857142857142855,7,1983,0
john crowley,Beasts,1983,5,0,2,1983,0
john crowley,The Deep,1984,6,8,1,1983,1
john crowley,Aegypt (Bantam Spectra Book),1987,7,0,1,1984,3
john crowley,Aegypt,1989,8,0,1,1987,2
john crowley,"Little, Big",1994,9,2.6666666666666665,3,1989,5
john crowley,"Pequeno, Grande",1998,10,2.5,2,1994,4
john crowley,Daemonomania,2000,11,0,1,1998,2
john crowley,The Translator,2002,12,3,2,2000,2
john crowley,"Little, Big",2002,13,1.5,6,2002,0
john crowley,Otherwise: Three Novels,2002,14,8.5,2,2002,0
john crowley,The Translator,2003,15,0.8,5,2002,1
john d. nesbitt,North of Cheyenne,2000,2,0,1,1997,3
john dalmas,The Yngling,1984,2,0,1,1983,1
john dalmas,FANGLITH,1985,3,5,1,1984,1
john dalmas,Varkaus Consp: Grassy Knoll,1987,4,0,1,1985,2
john dalmas,GENERALS PRESIDENT,1988,5,0,3,1987,1
john dalmas,The Lizard War,1989,6,2.5,2,1988,1
john dalmas,The LANTERN OF GOD,1989,7,0,1,1989,0
john dalmas,The White Regiment,1990,8,9,1,1989,1
john dalmas,The Regiment,1991,9,9,1,1990,1
john dalmas,The Regiment's War,1993,10,4.5,2,1991,2
john dalmas,The YNGLING IN YAMATO,1994,11,7,1,1993,1
john dalmas,The Lion of Farside,1995,12,0,1,1994,1
john dalmas,The BAVARIAN GATE,1997,13,0,1,1995,2
john dalmas,Soldiers,2001,14,0,1,1997,4
john dalmas,The Puppet Master,2001,15,0,1,2001,0
john dalmas,The Second Coming (The Millennium Series),2004,16,10,1,2001,3
john davies,A History of Wales,1995,2,9,1,1994,1
john donaldson,No Mardi Gras For The Dead,1995,2,0,3,1995,0
john donne,The Complete English Poems (Penguin English Poets),1971,2,9,1,1958,13
john donne,Complete English Poems: John Donne (Penguin Classics),1977,3,2,5,1971,6
john donne,The Love Poems of John Donne,1982,4,0,2,1977,5
john donne,Complete Poems (Everyman's library),1988,5,0,2,1982,6
john donne,"John Donne's Poetry: Authoritative Texts, Criticism (A Norton Critical Editions)",1991,6,5,2,1988,3
john donne,Selected Poems (Dover Thrift Editions),1994,7,2.4285714285714284,7,1991,3
john donne,Selected Poems,1994,8,9,1,1994,0
john donne,The Complete Poetry and Selected Prose of John Donne (Modern Library Series),1994,9,5,1,1994,0
john donne,Love Poems (Phoenix 60p Paperbacks - the Literature of Passion),1995,10,10,1,1994,1
john donne,The Complete Poetry and Selected Prose of John Donne (Modern Library Classics),2001,11,7.5,2,1995,6
john donne,"Geh, fang einen Stern, der fÃ?Â¤llt. Gedichte.",2001,12,0,1,2001,0
john donne,Selected Poetry (Oxford World's Classics),2001,13,9,1,2001,0
john donohue,Sensei,2004,2,0,1,2003,1
john dowd,Abalone Summer,1993,2,0,2,1988,5
john dowd,Sea Kayaking: A Manual for Long-Distance Touring,1997,3,0,1,1993,4
john e. douglas,UNABOMBER: ON THE TRAIL OF AMERICA'S MOST-WANTED SERIAL KILLER,1996,2,3.3333333333333335,3,1995,1
john e. douglas,Mindhunter : Inside the FBI's Elite Serial Crime Unit,1996,3,3.282608695652174,46,1996,0
john e. douglas,JOURNEY INTO DARKNESS (Lisa Drew Books (Paperback)),1997,4,2.2162162162162162,37,1996,1
john e. douglas,OBSESSION,1998,5,3.45,20,1997,1
john e. douglas,OBSESSION : THE FBIS LEGENDARY PROFILER PROBES THE PSYCHES OF KILLERS RAPISTS AND STALKER,1998,6,5,3,1998,0
john e. douglas,Man Down : A Broken Wings Thriller,2002,7,9,1,1998,4
john e. rybolt,Sirach (Collegeville Bible Commentary Old Testament 21),1986,2,0,1,1986,0
john e. thomas,The Ultimate Book of Holiday Kid Concoctions,2001,2,0,1,2000,1
john edwards,Four Trials,2003,2,0,1,1981,22
john elder,Reading the Mountains of Home,1999,2,0,1,1998,1
john fuller,Ghost of Flight 401,1983,2,5,2,1980,3
john fuller,Flying to Nowhere: A Tale,1984,3,0,1,1983,1
john fuller,Flying to Nowhere,1985,4,3,2,1984,1
john fuller,The Oxford Book of Sonnets (Oxford Books of Verse),2002,5,9,1,1985,17
john gierach,View From Rat Lake,1989,2,8,1,1988,1
john gierach,"Death, Taxes, and Leaky Waders : A John Gierach Fly-Fishing Treasury",2001,3,0,1,1989,12
john gooders,Where to Watch Birds in Britain and Europe (Where to Watch Birds),1997,2,10,1,1990,7
john gordon,The Ghost on the Hill (Plus S.),1989,2,0,1,1981,8
john grant,Laserbeak's Fury (The Transformers),1986,2,9,1,1985,1
john grant,Galvatron's Air Attack (The Transformers),1986,3,10,1,1986,0
john grant,Dr. Jekyll and Mr. Hyde (Library of Fear and Fantasy Series),1996,4,0,2,1986,10
john grant,Legendary Lighthouses,1998,5,7,2,1996,2
john grant,Great American Rail Journeys,2000,6,10,1,1998,2
john grant,Great American Rail Journeys (Broadcast Tie-Ins),2000,7,0,1,2000,0
john grant,"Legendary Lighthouses, Volume II",2001,8,7,1,2000,1
john grant,West Point: The First 200 Years: The First 200 Years,2002,9,10,1,2001,1
john gregory betancourt,Cutthroat Island: A Novel,1995,2,2.6,5,1995,0
john gregory betancourt,"The Heart of the Warrior (Star Trek: Deep Space Nine, No 17)",1996,3,2,10,1995,1
john gregory betancourt,Hercules: The Vengeance of Hera,1997,4,0,4,1996,1
john gregory betancourt,"Infection (Star Trek The Next Generation: Double Helix, Book 1)",1999,5,4.214285714285714,14,1997,2
john gregory betancourt,Roger Zelazny's The Dawn of Amber Book 1 (Dawn of Amber Trilogy),2002,6,5,2,1999,3
john gregory brown,Decorations in a Ruined Cemetery,1995,2,1.7142857142857142,7,1994,1
john gregory brown,"The Wrecked, Blessed Body of Shelton Lafleur",1996,3,0,1,1995,1
john gregory dunne,The studio (A Touchstone book),1979,2,0,1,1978,1
john gregory dunne,QUINTANA FRIENDS,1980,3,0,1,1979,1
john gregory dunne,DUTCH SHEA JR,1983,4,0,3,1980,3
john gregory dunne,The Red White and Blue,1987,5,0,1,1983,4
john gregory dunne,The Red White and Blue,1988,6,0,5,1987,1
john gregory dunne,Playland,1994,7,4,2,1988,6
john gregory dunne,Monster: Living Off the Big Screen,1997,8,3.3333333333333335,3,1994,3
john gribbin,In Search of the Double Helix,1987,2,2.3333333333333335,3,1984,3
john gribbin,"Cosmic Coincidences: Dark Matter, Mankind, and Anthropic Cosmology",1989,3,10,1,1987,2
john gribbin,Hothouse Earth: The Greenhouse Effect and Gaia,1991,4,4.333333333333333,3,1989,2
john gribbin,Reunion,1992,5,7,1,1991,1
john gribbin,Schrodinger's Kittens and the Search for Reality,1995,6,7,3,1992,3
john gribbin,In the Beginning: The Birth of the Living Universe (In the Beginning (Bay Back Books)),1995,7,8,1,1995,0
john gribbin,Schrodinger's Kittens and the Search for Reality : Solving the Quantum Mysteries Tag: Author of In Search of Schrod. Cat,1996,8,2,4,1995,1
john gribbin,Darwin in 90 Minutes: (1809-1882) (Scientists in 90 Minutes Series),1997,9,10,1,1996,1
john gribbin,"In Search of the Edge of Time: Black Holes, White Holes, Wormholes (Practical Resources for the Mental Health Professionals)",1999,10,0,2,1997,2
john gribbin,The Case of the Missing Neutrinos: And Other Curious Phenomena of the Universe,2000,11,8,1,1999,1
john gribbin,The Scientists : A History of Science Told Through the Lives of Its Greatest Inventors,2003,12,0,1,2000,3
john grisham,The Firm,1991,2,3.2142857142857144,28,1991,0
john grisham,The Firm,1991,3,0,1,1991,0
john grisham,The Firm,1992,4,3.0756143667296785,529,1991,1
john grisham,The Pelican Brief,1992,5,3.5,2,1992,0
john grisham,The Firm,1992,6,2.4,5,1992,0
john grisham,The Pelican Brief,1992,7,3.392857142857143,56,1992,0
john grisham,The Pelican Brief: International Edition,1992,8,0,1,1992,0
john grisham,A Time to Kill,1992,9,5.214285714285714,14,1992,0
john grisham,A Time to Kill,1992,10,8,2,1992,0
john grisham,A Time to Kill,1992,11,2.97678916827853,517,1992,0
john grisham,Die Jury. Roman.,1992,12,3.96,25,1992,0
john grisham,Die Firma. Roman.,1993,13,5.5,20,1992,1
john grisham,The Client (Large Print),1993,14,4,2,1993,0
john grisham,The Client,1993,15,2.9298245614035086,114,1993,0
john grisham,A Time to Kill,1993,16,5.2727272727272725,11,1993,0
john grisham,The Client,1993,17,3.3333333333333335,3,1993,0
john grisham,The Firm,1993,18,0,1,1993,0
john grisham,The Client (Limited Edition),1993,19,6.333333333333333,3,1993,0
john grisham,The Client,1993,20,0,1,1993,0
john grisham,A Time to Kill,1993,21,10,1,1993,0
john grisham,Die Akte.,1993,22,9,1,1993,0
john grisham,The Pelican Brief,1993,23,2.5239005736137665,523,1993,0
john grisham,The Client: International Edition,1993,24,0,3,1993,0
john grisham,Der Klient.,1994,25,10,1,1993,1
john grisham,The Chamber,1994,26,6.666666666666667,6,1994,0
john grisham,Die Akte. Roman.,1994,27,3,14,1994,0
john grisham,The Chamber,1994,28,3.2950819672131146,122,1994,0
john grisham,The Chamber (Limited Edition),1994,29,0,1,1994,0
john grisham,The Client,1994,30,3.1397260273972605,365,1994,0
john grisham,The Chamber,1995,31,2.862796833773087,379,1994,1
john grisham,The Chamber,1995,32,8,1,1995,0
john grisham,L' Affaire Pelican,1995,33,0,2,1995,0
john grisham,"Cliente, El",1995,34,6,1,1995,0
john grisham,Tiempo De Matar: Historia De Una Venganza,1995,35,5,2,1995,0
john grisham,LA Tapadera/the Firm (The Firm),1995,36,0,1,1995,0
john grisham,"The Rainmaker, Limited Edition",1995,37,10,1,1995,0
john grisham,Der Klient.,1995,38,4.222222222222222,9,1995,0
john grisham,The Rainmaker,1995,39,3.86,100,1995,0
john grisham,The Chamber,1995,40,0,1,1995,0
john grisham,Die Kammer.,1995,41,3.4,5,1995,0
john grisham,The Rainmaker,1995,42,0,1,1995,0
john grisham,The Rainmaker,1996,43,10,1,1995,1
john grisham,El Jurado,1996,44,3.5,2,1996,0
john grisham,The Rainmaker,1996,45,2.8333333333333335,6,1996,0
john grisham,The Runaway Jury: Slipcase,1996,46,3,2,1996,0
john grisham,The Runaway Jury,1996,47,7.5,2,1996,0
john grisham,Der Regenmacher.,1996,48,5.6,5,1996,0
john grisham,The Rainmaker,1996,49,2.6580310880829017,386,1996,0
john grisham,The Runaway Jury,1996,50,7,2,1996,0
john grisham,The Runaway Jury,1996,51,3,9,1996,0
john grisham,Die Kammer.,1996,52,3.5,12,1996,0
john grisham,The Runaway Jury,1996,53,2.988372093023256,86,1996,0
john grisham,The Runaway Jury,1997,54,2.8090692124105012,419,1996,1
john grisham,The Firm,1997,55,0,2,1997,0
john grisham,El Cliente,1997,56,0,1,1997,0
john grisham,The Partner,1997,57,3,7,1997,0
john grisham,The Rainmaker,1997,58,4,2,1997,0
john grisham,La tapadera,1997,59,7,1,1997,0
john grisham,El Socio,1997,60,5,1,1997,0
john grisham,Tiempo De Matar,1997,61,8,1,1997,0
john grisham,Der Regenmacher.,1997,62,4.555555555555555,18,1997,0
john grisham,The Partner (special edition),1997,63,0,1,1997,0
john grisham,The Partner,1997,64,6,1,1997,0
john grisham,Das Urteil.,1997,65,4,2,1997,0
john grisham,The Partner,1997,66,3.6611570247933884,121,1997,0
john grisham,Die Kammer,1998,67,4.666666666666667,3,1997,1
john grisham,Das Urteil.,1998,68,3.5714285714285716,7,1998,0
john grisham,Die Jury,1998,69,4,2,1998,0
john grisham,Der Regenmacher.,1998,70,7,2,1998,0
john grisham,The Partner,1998,71,3.160458452722063,349,1998,0
john grisham,Die Jury,1998,72,9,1,1998,0
john grisham,"Jurado, El",1998,73,10,1,1998,0
john grisham,The Rainmaker,1998,74,3.4,5,1998,0
john grisham,Camara De Gas,1998,75,0,1,1998,0
john grisham,The Street Lawyer,1998,76,3.411290322580645,124,1998,0
john grisham,The Street Lawyer,1999,77,2.6754617414248023,379,1998,1
john grisham,Le MaÃ?Â®tre du jeu,1999,78,0,1,1999,0
john grisham,El Socio,1999,79,2.5,2,1999,0
john grisham,The Street Lawyer,1999,80,2.41025641025641,39,1999,0
john grisham,The Testament,1999,81,2.3333333333333335,3,1999,0
john grisham,El Testamento,1999,82,7,1,1999,0
john grisham,The Testament,1999,83,4,2,1999,0
john grisham,The Testament,1999,84,3.2,75,1999,0
john grisham,The Street Lawyer,1999,85,9,1,1999,0
john grisham,The Street Lawyer,1999,86,7,2,1999,0
john grisham,Der Verrat.,1999,87,4.5,2,1999,0
john grisham,Der Partner.,1999,88,5.714285714285714,7,1999,0
john grisham,The Testament,1999,89,3.495575221238938,113,1999,0
john grisham,The Testament,1999,90,3.085308056872038,422,1999,0
john grisham,"The Client (Penguin Readers, Level 4)",2000,91,6,3,1999,1
john grisham,Der Verrat.,2000,92,6,5,2000,0
john grisham,Das Testament.,2000,93,4.5,2,2000,0
john grisham,"A Time to Kill (Penguin Readers, Level 5)",2000,94,5,2,2000,0
john grisham,Der Partner. Sonderausgabe.,2000,95,9,1,2000,0
john grisham,L'Associe,2000,96,0,1,2000,0
john grisham,The Brethren,2000,97,9,1,2000,0
john grisham,The Brethren,2000,98,0,1,2000,0
john grisham,The Brethren,2000,99,3.0694444444444446,144,2000,0
john grisham,The Brethren,2000,100,2.7573529411764706,408,2000,0
john grisham,The Brethren,2000,101,4.5,2,2000,0
john grisham,Causa justa,2000,102,5,1,2000,0
john grisham,La hermandad,2001,103,3.375,8,2000,1
john grisham,El testamento,2001,104,3.8,5,2001,0
john grisham,Skipping Christmas,2001,105,4.252380952380952,210,2001,0
john grisham,A Painted House: A Novel (Random House Large Print),2001,106,0,1,2001,0
john grisham,La Loi Du Plus Faible / The Law of Weakest,2001,107,10,1,2001,0
john grisham,Skipping Christmas,2001,108,3.5,4,2001,0
john grisham,Skipping Christmas,2001,109,0,1,2001,0
john grisham,A Painted House,2001,110,7,2,2001,0
john grisham,Non Coupable,2001,111,3.75,4,2001,0
john grisham,Skipping Christmas,2001,112,5,1,2001,0
john grisham,A Painted House,2001,113,4,2,2001,0
john grisham,LA Granja,2001,114,5,1,2001,0
john grisham,Die Bruderschaft.,2001,115,0,2,2001,0
john grisham,Das Testament,2001,116,1.2857142857142858,7,2001,0
john grisham,A Painted House,2001,117,3.3369565217391304,184,2001,0
john grisham,A Painted House,2001,118,3.187017001545595,647,2001,0
john grisham,A Painted House (Limited Edition),2001,119,0,1,2001,0
john grisham,L'idÃ?Â©aliste,2001,120,7,1,2001,0
john grisham,El Testamento (Punto de Lectura),2002,121,6,2,2001,1
john grisham,Skipping Christmas,2002,122,3.4752475247524752,101,2002,0
john grisham,The Summons,2002,123,3.954314720812183,197,2002,0
john grisham,Die Farm. Roman.,2002,124,0,2,2002,0
john grisham,El Socio,2002,125,0,1,2002,0
john grisham,Una Navidad Diferente,2002,126,3.857142857142857,7,2002,0
john grisham,LA Casa Dipinta,2002,127,0,2,2002,0
john grisham,Skipping Christmas,2002,128,5.4,5,2002,0
john grisham,The Summons,2002,129,3.1951754385964914,456,2002,0
john grisham,Il Confratelli,2002,130,0,1,2002,0
john grisham,Le Testament,2002,131,1.6666666666666667,3,2002,0
john grisham,The WaveDancer Benefit,2002,132,5,1,2002,0
john grisham,El Jurado (Punto de Lectura),2002,133,0,1,2002,0
john grisham,The WaveDancer Benefit,2002,134,0,1,2002,0
john grisham,LA Granja (Punto de Lectura),2002,135,4.5,2,2002,0
john grisham,La Citacion,2002,136,0,1,2002,0
john grisham,The Summons (Limited Edition),2002,137,5,1,2002,0
john grisham,The Summons,2002,138,4,1,2002,0
john grisham,Il Testamento/the Testament,2002,139,0,1,2002,0
john grisham,"The Brethren (Penguin Readers, Level 5)",2002,140,0,1,2002,0
john grisham,The Runaway Jury,2003,141,4,2,2002,1
john grisham,Der Richter.,2003,142,3.8,10,2003,0
john grisham,Das Fest,2003,143,4.857142857142857,7,2003,0
john grisham,Die Schuld.,2003,144,9,1,2003,0
john grisham,Bleachers,2003,145,3.2582781456953644,151,2003,0
john grisham,La citaciÃ³n (The Summons),2003,146,4,1,2003,0
john grisham,Una navidad diferente (Skipping Christmas),2003,147,8,1,2003,0
john grisham,The King of Torts,2003,148,2.908713692946058,241,2003,0
john grisham,The King of Torts,2003,149,5,3,2003,0
john grisham,The King of Torts (Random House Large Print),2003,150,4,2,2003,0
john grisham,The King of Torts,2003,151,4,4,2003,0
john grisham,Rey De Los Pleitos,2003,152,7.5,4,2003,0
john grisham,L'Engrenage,2003,153,0,1,2003,0
john grisham,The King of Torts,2003,154,3.142857142857143,210,2003,0
john grisham,Die Bruderschaft,2003,155,4.285714285714286,14,2003,0
john grisham,A Time to Kill,2004,156,6,3,2003,1
john grisham,A Painted House,2004,157,3.3333333333333335,3,2004,0
john grisham,The Last Juror,2004,158,0,1,2004,0
john grisham,The Last Juror,2004,159,4,2,2004,0
john grisham,The Last Juror,2004,160,4.654867256637168,113,2004,0
john grisham,Bleachers,2004,161,3.6842105263157894,38,2004,0
john grisham,The Firm (Random House Large Print),2004,162,0,1,2004,0
john grisham,The Last Juror,2004,163,0,1,2004,0
john healy,Streets Above Us,1991,2,8,1,1991,0
john howard,"Easy Company and the Headline Hunter, No 10 (Easy Company)",1981,2,0,1,1973,8
john howard,"Easy Company on the Oklahoma Trail, No 13",1982,3,0,1,1981,1
john howard,I Can Read About Dinosaurs (I Can Read About),1996,4,7,1,1982,14
john howard,I Can Read About Fossils (I Can Read About Series),1997,5,0,1,1996,1
john hurst,Come back to Eden: Lakeland's northern neighbour,2000,2,0,1,1983,17
john j. ratey,"A User's Guide to the Brain: Perception, Attention, and the Four Theaters of the Brain",2002,2,9,1,2001,1
john katzenbach,The Traveler,1987,2,2.6666666666666665,3,1983,4
john katzenbach,Day of Reckoning,1989,3,0,1,1987,2
john katzenbach,Day of Reckoning,1990,4,1,5,1989,1
john katzenbach,The Traveler,1993,5,1.1428571428571428,7,1990,3
john katzenbach,Just Cause,1995,6,3.380952380952381,21,1993,2
john katzenbach,Der Sumpf. Roman.,1995,7,2,2,1995,0
john katzenbach,The Shadow Man,1995,8,0,2,1995,0
john katzenbach,The Shadow Man,1996,9,1.6666666666666667,9,1995,1
john katzenbach,State of Mind,1997,10,2.3333333333333335,3,1996,1
john katzenbach,State of Mind,1998,11,2.142857142857143,14,1997,1
john katzenbach,Hart's War,1999,12,1.75,8,1998,1
john katzenbach,Hart's War,2000,13,1.9,20,1999,1
john katzenbach,The Analyst,2002,14,5.166666666666667,6,2000,2
john katzenbach,El Psicoanalista,2003,15,5.5,6,2002,1
john katzenbach,The Analyst,2003,16,2.76,25,2003,0
john katzenbach,"The Madman's Tale (Katzenbach, John)",2004,17,10,1,2003,1
john keay,India: A History,2001,2,0,1,1997,4
john kennedy toole,A confederacy of dunces,1981,2,4.933333333333334,15,1980,1
john kennedy toole,A confederacy of dunces,1982,3,3.764705882352941,17,1981,1
john kennedy toole,A Confederacy of Dunces (Evergreen Book),1987,4,3.5755395683453237,139,1982,5
john kennedy toole,Ignaz oder Die VerschwÃ?Â¶rung der Idioten. Roman.,1988,5,4.222222222222222,9,1987,1
john kennedy toole,The Neon Bible,1990,6,2.75,8,1988,2
john kennedy toole,La Conjura de Los Necios,1994,7,3.3076923076923075,13,1990,4
john kennedy toole,A Confederacy of Dunces,1995,8,3.4545454545454546,77,1994,1
john kennedy toole,La Bible de nÃ?Â©on,1995,9,0,1,1995,0
john kennedy toole,A Confederacy of Dunces,2000,10,5.333333333333333,3,1995,5
john kennedy toole,La Conjuration des imbÃ?Â©ciles,2002,11,4.666666666666667,6,2000,2
john king,The Celtic Druids' Year: Seasonal Cycles of the Ancient Celts,1996,2,0,1,1989,7
john king,FuÃ?Â?ball Factory. Der letzte Kick.,2000,3,7,1,1996,4
john king,Lonely Planet Wales (Lonely Planet Wales),2001,4,0,3,2000,1
john lantigua,The Ultimate Havana,2001,2,0,1,1990,11
john le carrã?â©,Le voyageur secret,1993,2,6,1,1973,20
john le carrã?â©,Our game,1995,3,4.5,2,1993,2
john le carrã?â©,La Taupe,2001,4,0,1,1995,6
john lecarre,Eine Art Held. Roman.,1985,2,0,1,1984,1
john lecarre,Ein blendender Spion. Roman.,1989,3,0,1,1985,4
john lecarre,The Secret Pilgrim,1990,4,2.466666666666667,15,1989,1
john lecarre,Das RuÃ?Â?land- Haus. Roman.,1991,5,3.8,5,1990,1
john lecarre,Der Nacht- Manager.,1994,6,2.3333333333333335,3,1991,3
john lecarre,Der Schneider von Panama.,1999,7,0.3333333333333333,6,1994,5
john lecarre,Der Schneider von Panama.,2001,8,2,2,1999,2
john lecarre,The Russia House,2001,9,0,1,2001,0
john lecarre,Single und Single.,2001,10,0,2,2001,0
john lecarre,Der ewige GÃ?Â¤rtner. Roman.,2001,11,9,1,2001,0
john lecarre,Der ewige GÃ?Â¤rtner.,2002,12,4.5,2,2001,1
john mason,Don't Wait for Your Ship to Come In...Swim Out to Meet It!: Bite-Sized Inspirations to Help You Achieve Your Dreams,1994,2,0,2,1993,1
john mason,Conquering an Enemy Called Average,1996,3,0,2,1994,2
john mason,Haunted Heritage,1999,4,0,1,1996,3
john masters,"Now, God be thanked: A novel (His Loss of Eden)",1979,2,5,1,1956,23
john masters,Now God Be Thanked,1980,3,0,2,1979,1
john masters,High Command,1984,4,0,1,1980,4
john masters,Bugles and a Tiger: A Volume of Autobiography,1990,5,8,1,1984,6
john matthews,"A Celtic Reader: Selections from Celtic Legend, Scholarship and Story",1992,2,0,1,1989,3
john matthews,"The World Atlas of Divination: The Systems, Where They Originate, How They Work",1992,3,8,1,1992,0
john matthews,Celtic Warrior Chiefs,1993,4,8.5,2,1992,1
john matthews,The Little Book of Celtic Wisdom (Little Book),1993,5,5,3,1993,0
john matthews,The Little Book of Arthurian Wisdom (Element's Lttle Book Series),1994,6,10,1,1993,1
john matthews,The Eyeball Killer,1996,7,0,1,1994,2
john matthews,"""The Elements of the Grail Tradition (\Elements of ... """" Series)""""""",1996,8,0,1,1996,0
john matthews,"""Elements of the Arthurian Tradition (\Elements of ... """" Series)""""""",1997,9,0,2,1996,1
john matthews,Mystic Grail: The Challenge of the Arthurian Quest,1997,10,8,1,1997,0
john matthews,Tales of the Celtic Otherworld,1998,11,0,1,1997,1
john matthews,The Winter Solstice: The Sacred Traditions of Christmas,1998,12,9.333333333333334,3,1998,0
john matthews,Das vergessene Kind.,2000,13,0,3,1998,2
john matthews,At the Table of the Grail: No One Who Sets Forth on the Grail Quest Remains Unchanged,2002,14,5,1,2000,2
john matthews,The Summer Solstice,2002,15,10,1,2002,0
john matthews,Secrets of the Druids,2002,16,0,1,2002,0
john matthews,Der einzige Zeuge.,2002,17,0,1,2002,0
john mcmurry,Chemistry,1994,2,10,1,1990,4
john mcnally,High Infidelity: 24 Great Short Stories About Adultery by Some of Our Best Contemporary Authors,1998,2,4,2,1997,1
john mcnulty,This Place on Third Avenue: The New York Stories of John McNulty,2002,2,1.25,4,2001,1
john meade falkner,Moonfleet (Penguin Popular Classics),1995,2,2.6666666666666665,6,1988,7
john montgomery,Underground Guide to UNIX: Slightly Askew Advice from a UNIX Guru,1995,2,6,1,1975,20
john montroll,Origami Sea Life (Origami),1991,2,0,1,1991,0
john montroll,Dollar Bill Animals in Origami: The National Origami Treasury (Origami),2000,3,0,1,1991,9
john mortimer,The Trials of Rumpole,1979,2,1.3333333333333333,6,1978,1
john mortimer,Rumpole's Return,1982,3,4.666666666666667,3,1979,3
john mortimer,Clinging to the Wreckage,1983,4,2.727272727272727,11,1982,1
john mortimer,Rumpole and the Golden Thread,1983,5,1.75,4,1983,0
john mortimer,A First Rumpole Omnibus,1984,6,2.8333333333333335,6,1983,1
john mortimer,Rumpole and the Golden Thread,1984,7,0,1,1984,0
john mortimer,In Character,1984,8,0,1,1984,0
john mortimer,Paradise Postponed,1986,9,0,3,1984,2
john mortimer,Rumpoles Last Case,1987,10,0,1,1986,1
john mortimer,Clinging to the Wreckage: A Part of Life,1987,11,7,1,1987,0
john mortimer,Rumpole and the Age of Miracles,1988,12,8,1,1987,1
john mortimer,Charade,1988,13,4.5,2,1988,0
john mortimer,The Narrowing Stream,1989,14,0,1,1988,1
john mortimer,Rumpole and the Age of Miracles,1989,15,4.5,2,1989,0
john mortimer,Summer's Lease,1989,16,4,2,1989,0
john mortimer,The Narrowing Stream,1989,17,7.5,2,1989,0
john mortimer,Summer's Lease,1989,18,0,5,1989,0
john mortimer,The Second Rumpole Omnibus (Crime Monthly),1989,19,7,2,1989,0
john mortimer,Titmuss Regained,1990,20,8,1,1989,1
john mortimer,Titmuss Regained,1991,21,10,1,1990,1
john mortimer,Rumpole a La Carte,1991,22,0,1,1991,0
john mortimer,Rumpole for the Prosecution/Rumpole and the Summer of Discontent,1992,23,0,1,1991,1
john mortimer,Rumpole and the Judges Elbow/Audio Cassette,1992,24,2.3333333333333335,3,1992,0
john mortimer,Rumpole on Trial,1992,25,2,4,1992,0
john mortimer,Dunster,1993,26,3.4,5,1992,1
john mortimer,The Rapstone Chronicles: Paradise Postponed/Titmuss Regained,1993,27,0,1,1993,0
john mortimer,Dunster,1993,28,0,1,1993,0
john mortimer,Rumpole on Trial,1993,29,8,1,1993,0
john mortimer,The Best of Rumpole,1994,30,0,1,1993,1
john mortimer,Rumpole's Last Case,1994,31,7,1,1994,0
john mortimer,Murderers and Other Friends,1995,32,0,1,1994,1
john mortimer,Rumpole and the Younger Generation (Penguin 60s S.),1995,33,1.625,8,1995,0
john mortimer,The Trials of Rumpole,1996,34,7,1,1995,1
john mortimer,Rumpole and the Angel of Death,1996,35,0,1,1996,0
john mortimer,Murderers and Other Friends: Another Part of Life,1996,36,8,1,1996,0
john mortimer,Rumpole for the Defense,1996,37,7,1,1996,0
john mortimer,Rumpole of the Bailey,1996,38,6,1,1996,0
john mortimer,Felix in the Underworld,1997,39,2.1666666666666665,6,1996,1
john mortimer,Rumpole and the Angel of Death,1997,40,0,1,1997,0
john mortimer,Paradise Postponed,1997,41,1.875,8,1997,0
john mortimer,Titmuss Regained,1998,42,0,2,1997,1
john mortimer,Felix in the Underworld,1998,43,0,1,1998,0
john mortimer,Felix In the Underworld,1998,44,6.5,2,1998,0
john mortimer,The Sound of Trumpets,1999,45,0,1,1998,1
john mortimer,Paradise Postponed,1999,46,2.375,8,1999,0
john mortimer,The Sound of Trumpets,1999,47,2.5,2,1999,0
john mortimer,The Summer of a Dormouse,2001,48,0,1,1999,2
john mortimer,Rumpole Rests His Case,2002,49,4.5,2,2001,1
john mortimer,Rumpole and the Primrose Path,2003,50,9.5,2,2002,1
john mortimer,Rumpole Rests His Case,2003,51,4.5,2,2003,0
john muirhead,THOSE WHO FALL,1987,2,0,1,1986,1
john murray,Jazz Etc.,2003,2,4,2,1998,5
john murray,A Few Short Notes on Tropical Butterflies : Stories,2003,3,2.6666666666666665,3,2003,0
john murray,A Few Short Notes on Tropical Butterflies : Stories,2004,4,0,1,2003,1
john n. maclean,Fire on the Mountain : The True Story of the South Canyon Fire,2000,2,0,3,1999,1
john n. walker,"Cinderella Trap (Harlequin Romance, No 2957)",1988,2,1,5,1982,6
john n. walker,MERIDIAN,1989,3,0,1,1988,1
john n. walker,The TEMPLE OF MY FAMILIAR  EXPORT,1989,4,0,1,1989,0
john n. walker,"Chase The Dawn (Harlequin Presents, 1196)",1989,5,2.5,2,1989,0
john n. walker,"Stormy Weather (Harlequin Superromance, No 417)",1990,6,0,2,1989,1
john n. walker,"Jester'S Girl (Harlequin Romance, No 3078)",1990,7,0,2,1990,0
john n. walker,"Give And Take (Harlequin Romance, No. 3174)",1991,8,10,1,1990,1
john n. walker,"Golden Thief (Harlequin Romance, No 3107)",1991,9,1.6666666666666667,3,1991,0
john n. walker,"No Gentleman (Harlequin Romance, 3245)",1992,10,0,1,1991,1
john n. walker,Zero At The Bone (A Katherine Driscoll Mystery),1993,11,2,4,1992,1
john n. walker,The APPEARANCE OF IMPROPRIETY,1994,12,4,1,1993,1
john n. walker,"Flirting With Danger (Dangerous Liaisons) (Harlequin Presents, No 1818)",1996,13,5,1,1994,2
john n. walker,"Yesterday'S Bride (Silhouette Intimate Moments, No 768)",1997,14,0,1,1996,1
john n. walker,Fixed In His Folly (Worldwide Library Mysteries),1999,15,0,1,1997,2
john n. walker,"Groom'S Revenge (Harlequin Presents, 2035)",1999,16,0,1,1999,0
john n. walker,"Constantine's Revenge (Harlequin Presents, #2082)",2000,17,0,1,1999,1
john n. walker,"Saturday'S Bride (Presents, 2131)",2000,18,6,1,2000,0
john n. walker,Rafael's Love-Child (Harlequin Presents #2160),2001,19,2.6666666666666665,3,2000,1
john n. walker,"Her Secret Bridegroom (Latin Lovers) (Presents, Latin Lovers 2191)",2001,20,0,1,2001,0
john n. walker,Hers For A Night,2002,21,0,1,2001,1
john nichols,The Nirvana Blues,1983,2,4.5,4,1979,4
john nichols,The Magic Journey,1983,3,3.142857142857143,7,1983,0
john nichols,Milagro Beanfield War,1986,4,4.5,4,1983,3
john nichols,The Sterile Cuckoo,1987,5,7,1,1986,1
john nichols,Wizard of Loneliness,1988,6,0,1,1987,1
john nichols,American Blood,1988,7,0,2,1988,0
john nichols,The Sky's the Limit: A Defense of the Earth,1990,8,2.6666666666666665,3,1988,2
john nichols,Keep It Simple: A Defense of the Earth,1993,9,0,1,1990,3
john nichols,The Wizard of Loneliness,1994,10,5,1,1993,1
john nichols,The Milagro Beanfield War,1994,11,0,2,1994,0
john nichols,Conjugal Bliss: A Comedy of Martial Arts,1994,12,2,3,1994,0
john nichols,The Sterile Cuckoo (Norton Paperback Fiction),1996,13,6,3,1994,2
john nichols,The Voice of the Butterfly,2001,14,5,1,1996,5
john nichols,Jews for Buchanan: Did You Hear the One About the Theft of the American Presidency?,2001,15,8,1,2001,0
john nichols,The Voice of the Butterfly,2003,16,4,2,2001,2
john o'farrell,The Best a Man Can Get: A Novel of Fatherhood and Its Discontents,2001,2,6.5,2,1999,2
john o'farrell,The Best a Man Can Get : A Novel,2002,3,4.444444444444445,9,2001,1
john o'farrell,"Global Village Idiot: Dubya, Dumb Jokes, and One Last Word Before You Vote",2003,4,0,1,2002,1
john o'farrell,This Is Your Life,2004,5,0,3,2003,1
john p. kotter,Leading Change,1996,2,0,2,1988,8
john p. kotter,The New Rules,1997,3,0,1,1996,1
john p. mckay,A History of Western Society: From Antiquity to the Enlightenment,1999,2,6,1,1997,2
john p. mckay,A History of Western Society: From Absolutism to the Present,1999,3,7,1,1999,0
john p. mckay,"A History of Western Society: From Antiquity to the Enlightenment, Chapters 1-17",2002,4,0,1,1999,3
john pina craven,The Silent War: The Cold War Battle Beneath the Sea,2002,2,0,1,2001,1
john r. hinnells,Who's Who of Religions (Penguin Reference Books),1996,2,0,1,1991,5
john r. hinnells,The Penguin Dictionary of Religions (Penguin Reference Books),1997,3,10,1,1996,1
john r. levine,Unix for Dummies (For Dummies S.),1993,2,0,1,1992,1
john r. levine,The Internet for Dummies Quick Reference,1994,3,6.5,2,1993,1
john r. levine,More Internet for Dummies (For Dummies),1994,4,0,1,1994,0
john r. levine,The Internet for Dummies,1994,5,4.166666666666667,6,1994,0
john r. levine,"Internet for Dummies,The",1995,6,1.6666666666666667,3,1994,1
john r. levine,Internet SECRETSÂ¨,1995,7,0,1,1995,0
john r. levine,Unix for Dummies (TRANS/DUM),1995,8,0,1,1995,0
john r. levine,The Internet for Dummies (4th Edition),1997,9,8,1,1995,2
john r. levine,"The Internet for Dummies Quick Reference, Third Edition",1997,10,5,2,1997,0
john r. levine,"The Internet for Dummies, Fifth Edition",1998,11,4.833333333333333,6,1997,1
john r. levine,Internet for Dummies,1999,12,0,1,1998,1
john r. levine,The Internet for Dummies,2000,13,3.3333333333333335,3,1999,1
john r. levine,Windows Millennium Edition: The Complete Reference,2000,14,7,1,2000,0
john r. levine,Internet All in One Desk Reference for Dummies: 9 books in 1. (with CD-ROM),2000,15,0,1,2000,0
john r. levine,The Internet for Dummies,2002,16,7,2,2000,2
john ramsey,The Death of Innocence: Jonbenet's Parents Tell Their Story,2001,2,2.4444444444444446,9,2000,1
john rember,Traplines: Coming Home to Sawtooth Valley,2003,2,8,1,1989,14
john ringo,Gust Front,2001,2,9,2,2000,1
john ringo,A Hymn Before Battle,2001,3,1.8888888888888888,9,2001,0
john ringo,When the Devil Dances,2002,4,7.5,2,2001,1
john ringo,Gust Front,2002,5,0,5,2002,0
john ringo,Hell's Faire,2003,6,4.666666666666667,6,2002,1
john ringo,There Will Be Dragons,2003,7,2.5,2,2003,0
john ringo,When the Devil Dances,2003,8,7.5,2,2003,0
john ringo,The Road to Damascus (The Bolo Series),2004,9,10,1,2003,1
john rosemond,Ending The Homework Hassle,1990,2,0,2,1989,1
john rosemond,Parent Power!,1991,3,0,2,1990,1
john rosemond,"""Making The \Terrible"""" Twos Terrific""""""",1993,4,9,2,1991,2
john rosemond,A Family Of Value,1995,5,0,1,1993,2
john ruskin,The King of the Golden River: A Legend of Stiria (Candlewick Treasures),2000,2,0,1,1998,2
john ruskin,Mornings in Florence,2003,3,0,1,2000,3
john sanders,The God Who Risks: A Theology of Providence,1998,2,0,1,1989,9
john sandford,Shadow Prey,1990,2,0,2,1989,1
john sandford,Eyes of Prey,1991,3,5,1,1990,1
john sandford,Silent Prey,1992,4,2.6666666666666665,3,1991,1
john sandford,Rules of Prey,1992,5,2.5757575757575757,99,1992,0
john sandford,Winter Prey,1993,6,4.166666666666667,6,1992,1
john sandford,Night Prey,1994,7,2.4285714285714284,21,1993,1
john sandford,Mind Prey,1995,8,4.3478260869565215,23,1994,1
john sandford,Three Complete Novels : Rules of Prey; Shadow Prey; Eyes of Prey,1995,9,0,2,1995,0
john sandford,Sudden Prey,1996,10,3.8333333333333335,18,1995,1
john sandford,Sudden Prey,1997,11,1.8295454545454546,88,1996,1
john sandford,The Night Crew,1997,12,3.1666666666666665,12,1997,0
john sandford,Shadow Prey,1997,13,4,2,1997,0
john sandford,Secret Prey (Cassette/Abridged),1998,14,0,1,1997,1
john sandford,Letzter Dreh.,1998,15,2.3333333333333335,3,1998,0
john sandford,Secret Prey,1998,16,3.3333333333333335,15,1998,0
john sandford,NIGHT PREY,1999,17,0,1,1998,1
john sandford,Die Jagdpartie.,1999,18,9,1,1999,0
john sandford,Certain Prey,1999,19,3.5,2,1999,0
john sandford,Certain Prey,1999,20,3.9615384615384617,26,1999,0
john sandford,Certain Prey,1999,21,8,1,1999,0
john sandford,Silent Prey,2000,22,2.3333333333333335,81,1999,1
john sandford,"Three Complete Novels: Mind Prey, Sudden Prey, Secret Prey",2000,23,10,1,2000,0
john sandford,Easy Prey,2000,24,0,2,2000,0
john sandford,Easy Prey,2000,25,3.4186046511627906,43,2000,0
john sandford,Certain Prey,2000,26,2.5757575757575757,99,2000,0
john sandford,Winter Prey : Low Price,2000,27,0,3,2000,0
john sandford,The Devil's Code,2000,28,3.1515151515151514,33,2000,0
john sandford,Chosen Prey,2001,29,0,2,2000,1
john sandford,Nachtblind.,2001,30,4,2,2001,0
john sandford,The Empress File,2001,31,2.574074074074074,54,2001,0
john sandford,Easy Prey,2001,32,2.7787610619469025,113,2001,0
john sandford,Chosen Prey,2001,33,3.4347826086956523,46,2001,0
john sandford,Trilogy of Mysteries,2002,34,3.5,2,2001,1
john sandford,Mortal Prey,2002,35,0,1,2002,0
john sandford,Mortal Prey,2002,36,3.84375,64,2002,0
john sandford,TÃ?Â¶dlicher Blick. Ein Lucas- Davenport- Roman.,2002,37,4.5,2,2002,0
john sandford,The Hanged Man's Song,2003,38,2.869565217391304,23,2002,1
john sandford,Naked Prey,2003,39,3.4909090909090907,55,2003,0
john sandford,Naked Prey,2003,40,0,1,2003,0
john sandford,Naked Prey,2003,41,0,1,2003,0
john sandford,Night Prey,2003,42,0,1,2003,0
john sandford,Mortal Prey,2003,43,2.36,100,2003,0
john sandford,Secret Prey,2003,44,2.814814814814815,81,2003,0
john sandford,Hidden Prey,2004,45,4.0344827586206895,29,2003,1
john sandford,The Night Crew,2004,46,2.9342105263157894,76,2004,0
john sandford,Chosen Prey,2004,47,3.1805555555555554,144,2004,0
john sandford,Naked Prey (Prey),2004,48,2.742857142857143,35,2004,0
john sandford,Night Prey,2004,49,2.0588235294117645,85,2004,0
john sandford,The Devil's Code,2004,50,2.875,88,2004,0
john sandford,The Fool's Run,2004,51,2.081967213114754,61,2004,0
john sandford,Eyes of Prey,2004,52,3.0588235294117645,85,2004,0
john sandford,Shadow Prey,2004,53,2,79,2004,0
john sandford,Mind Prey,2004,54,2.259259259259259,81,2004,0
john sandford,Winter Prey,2004,55,2.6582278481012658,79,2004,0
john saul,The God Project,1983,2,2.608695652173913,23,1980,3
john saul,God Project,1983,3,1.6923076923076923,26,1983,0
john saul,Nathaniel,1984,4,2.5833333333333335,36,1983,1
john saul,Nathaniel,1984,5,1.9523809523809523,21,1984,0
john saul,Brainchild,1985,6,2.0434782608695654,23,1984,1
john saul,Brain Child,1985,7,2.3214285714285716,28,1985,0
john saul,The God Project,1985,8,0,1,1985,0
john saul,Suffer the Children,1986,9,2.95,20,1985,1
john saul,Hellfire,1986,10,1.8064516129032258,31,1986,0
john saul,Cry for the Strangers,1986,11,3.3461538461538463,26,1986,0
john saul,Suffer the Children,1986,12,8,1,1986,0
john saul,The Unwanted,1987,13,1.6458333333333333,48,1986,1
john saul,The Unloved,1988,14,2.5588235294117645,34,1987,1
john saul,Creature,1989,15,1.6666666666666667,9,1988,1
john saul,Creature,1990,16,2.4642857142857144,56,1989,1
john saul,Comes the Blind Fury,1990,17,2.4827586206896552,29,1990,0
john saul,Second Child,1990,18,1,8,1990,0
john saul,When the Wind Blows,1990,19,1.7692307692307692,26,1990,0
john saul,Punish the Sinners,1990,20,2.230769230769231,39,1990,0
john saul,Bestien. Roman.,1990,21,0,1,1990,0
john saul,Darkness,1991,22,0.8571428571428571,7,1990,1
john saul,Brain Child,1991,23,0,2,1991,0
john saul,Second Child,1991,24,8,1,1991,0
john saul,Darkness,1992,25,1.9821428571428572,56,1991,1
john saul,Shadows,1992,26,1.6666666666666667,9,1992,0
john saul,Shadows,1993,27,1.5714285714285714,56,1992,1
john saul,Comes the Blind Fury,1993,28,1.6,5,1993,0
john saul,Guardian,1993,29,1.4615384615384615,13,1993,0
john saul,Schule des Schreckens.,1993,30,0,1,1993,0
john saul,La Indeseable,1994,31,0,1,1993,1
john saul,The Homing,1994,32,2.6,10,1994,0
john saul,Sleepwalk,1994,33,0,1,1994,0
john saul,Guardian,1995,34,1.5737704918032787,61,1994,1
john saul,Three Complete Novels/Brainchild/Nathaniel/the God Project: A New Collection of Three Complete Novels,1995,35,3.5,2,1995,0
john saul,The Homing,1995,36,1.5925925925925926,54,1995,0
john saul,Black Lightning,1995,37,2.3846153846153846,13,1995,0
john saul,John Saul: Three Terrifying Bestselling Novels,1996,38,0,3,1995,1
john saul,Black Lightning,1996,39,2.42,50,1996,0
john saul,"In the Shadow of Evil: The Handkerchief (The Blackstone Chronicles , No 4)",1997,40,2.2857142857142856,14,1996,1
john saul,"Asylum (Blackstone Chronicles, No 6)",1997,41,2.9473684210526314,19,1997,0
john saul,The Presence,1997,42,4.777777777777778,9,1997,0
john saul,"Ashes to Ashes: The Dragon's Flame (Blackstone Chronicles, Part 3)",1997,43,1.7058823529411764,17,1997,0
john saul,"Twist of Fate: The Locket (The Blackstone Chronicles, No 2)",1997,44,2.7,20,1997,0
john saul,The Blackstone Chronicles,1997,45,3,3,1997,0
john saul,Blackstone Chronicles,1997,46,1.6428571428571428,14,1997,0
john saul,"An Eye for an Eye: The Doll (Blackstone Chronicles, No 1)",1997,47,2.6363636363636362,22,1997,0
john saul,Second Child,1997,48,1.3709677419354838,62,1997,0
john saul,"Day of Reckoning: The Stereoscope (Blackstone Chronicles, Part 5)",1997,49,1.8666666666666667,15,1997,0
john saul,Sleepwalk,1997,50,1.5740740740740742,54,1997,0
john saul,The Blackstone Chronicles (Blackstone Chronicles),1998,51,1.1176470588235294,17,1997,1
john saul,The Presence,1998,52,3.25,56,1998,0
john saul,The Right Hand of Evil,1999,53,2.3846153846153846,26,1998,1
john saul,Alerta,1999,54,3,2,1999,0
john saul,Comes the Blind Fury,1999,55,0,1,1999,0
john saul,"Die Blackstone Chroniken. Geschenke, die den Horror bringen.",2000,56,2,5,1999,1
john saul,Nightshade,2000,57,1.3333333333333333,15,2000,0
john saul,Kind der HÃ?Â¶lle.,2000,58,4.5,2,2000,0
john saul,The Right Hand of Evil,2000,59,1.8717948717948718,78,2000,0
john saul,The Manhattan Hunt Club,2001,60,6.2,10,2000,1
john saul,Nightshade,2001,61,2.76,75,2001,0
john saul,The Homing,2002,62,3.3846153846153846,13,2001,1
john saul,Midnight Voices,2002,63,3.388888888888889,18,2002,0
john saul,Manhattan Hunt Club,2002,64,3.5045045045045047,111,2002,0
john saul,Midnight Voices (Unabridged - 7 Cassettes / 11 Hours),2002,65,0,1,2002,0
john saul,Midnight Voices,2003,66,3.5294117647058822,68,2002,1
john saul,Der Club der Gerechten.,2003,67,0,1,2003,0
john saul,"Black Creek Crossing (Saul, John)",2004,68,2.8125,16,2003,1
john saul,Black Creek Crossing (Ay Spoken Word - Saul),2004,69,0,2,2004,0
john seabrook,DEEPER : ADVENTURES ON THE NET,1998,2,1,4,1997,1
john seabrook,Nobrow: The Culture of Marketing-The Marketing of Culture,2000,3,5.333333333333333,3,1998,2
john seabrook,"Nobrow : The Culture of Marketing, the Marketing of Culture",2001,4,6,3,2000,1
john shelby spong,Rescuing the Bible from Fundamentalism : A Bishop Rethinks the Meaning of Scripture,1992,2,2.272727272727273,11,1991,1
john shelby spong,Born of a Woman,1992,3,0,1,1992,0
john shelby spong,Resurrection: Myth or Reality? : A Bishop's Search for the Origins of Christianity,1994,4,5,1,1992,2
john shelby spong,Born of a Woman,1994,5,8,1,1994,0
john shelby spong,Liberating the Gospels : Reading the Bible with Jewish Eyes,1997,6,6,1,1994,3
john shelby spong,Why Christianity Must Change or Die,1998,7,8,1,1997,1
john shelby spong,Why Christianity Must Change Or Die,1998,8,7,1,1998,0
john shelby spong,Why Christianity Must Change or Die: A Bishop Speaks to Believers In Exile,1999,9,3,3,1998,1
john shelby spong,"Here I Stand: My Struggle for a Christianity of Integrity, Love, and Equality",2000,10,4,1,1999,1
john shelby spong,A New Christianity for a New World: Why Traditional Faith Is Dying and How a New Faith Is Being Born,2001,11,8,2,2000,1
john shelby spong,A New Christianity for a New World : Why Traditional Faith is Dying &amp; How a New Faith is Being Born,2002,12,4,2,2001,1
john stanley,Classical Music: An Introduction to Classical Music Through the Great Composers &amp; Their Masterworks,1994,2,0,1,1976,18
john szwed,So What: The Life of Miles Davis,2002,2,0,1,2000,2
john t molloy,Dress for Success,1985,2,0,1,1977,8
john taylor gatto,Dumbing Us Down: The Hidden Curriculum of Compulsory Schooling,1991,2,0,1,1991,0
john taylor gatto,A Different Kind of Teacher: Solving the Crisis of American Schooling,2000,3,0,1,1991,9
john taylor gatto,Dumbing Us Down: The Hidden Curriculum of Compulsory Schooling,2002,4,5,2,2000,2
john thackray,British Fossils,1984,2,10,1,1980,4
john thackray,The Natural History Museum: Nature's Treasure House,2001,3,9,1,1984,17
john townsend,The Mom Factor,1998,2,9,1,1996,2
john w. dower,Embracing Defeat: Japan in the Wake of World War II,2000,2,0,3,1987,13
john wagner,Predator vs. Judge Dredd,1998,2,0,1,1997,1
john wainwright,The Man Who Wasn't There,1989,2,0,1,1988,1
john wainwright,Wainwright's Beat,1989,3,0,1,1989,0
john wallace,In My World: My Toys (In My World),2001,2,6,1,1998,3
john walsh,Tears of Rage,1998,2,3.5294117647058822,17,1997,1
john walsh,NO MERCY,1998,3,2,2,1998,0
john walsh,No Mercy,1999,4,3.375,8,1998,1
john walsh,Public Enemies: The Host of America's Most Wanted Targets the Nation's Most Notorious Criminals,2001,5,0,1,1999,2
john walsh,Public Enemies : The Host of America's Most Wanted Targets the Nation's Most Notorious Criminals,2002,6,5.125,8,2001,1
john whitcomb,Real Life at the White House: Two Hundred Years of Daily Life at America's Most Famous Residence,2000,2,7,1,1988,12
john wittich,Discovering London Curiosities (Discovering),1997,2,9,1,1977,20
john wittich,Discovering Off-Beat Walks in London (Discovering),1999,3,9,1,1997,2
john wray,The Right Hand of Sleep,2002,2,1.4285714285714286,7,2001,1
"john, sir betjeman","Ghastly Good Taste: Or, a Depressing Story of the Rise and Fall of English Architecture (National Trust Classics)",1986,2,0,3,1982,4
"john, sir betjeman",English Love Poems,1988,3,0,1,1986,2
"john, sir betjeman",John Betjeman: Collected Poems,1990,4,5,2,1988,2
john-roger mcwilliams,Life 101: Everything We Wish We Had Learned in High School-But Didn't,1991,2,5.090909090909091,11,1991,0
